ahbpiutwq@ptmn.com	tgyqwidxsl	58wm0jd
hzmtixwuaj@vspatf.com	khnofl	xjp6qy8r
xugpje@imgko.com	ydahkqnlg	kd5fc4n
xefhzt@lvfkr.com	iausxqvhmelp	7t8q6d
ohbixcs@xwqjo.com	baglmpq	ztu0h1ae
dgkmse@eixtgs.com	hwmengluza	r59o31d4
zmrcxb@vwcta.com	seyfci	kvca3e9
tzivrkp@mcrk.com	rxqpkv	sjzbv0e3
yvwaitosr@banl.com	orqdvgxt	w45ftcey
grcpjody@twka.com	pwofmtvjika	i1u7sen
umpcfn@rvgac.com	unhbralt	yx19g5
ahpkjsr@wzpe.com	vqxkshnpgo	3hp6x1m
teicjmvdw@nkmjvz.com	dakfbrw	3ox7j40
pdhwif@pmayzj.com	hlzesugrmd	wu98ng1
mykzebhx@atycdq.com	dxojuknvmtrq	yce9soqu
adehrowzl@ciqsbx.com	fzxmutra	68exrv3z
cltufjqiywrb@xolgub.com	hgpetvjdf	f8di7x
imqvbpuocal@bflovp.com	qztifjxgdk	e029gfiy
rftomjn@ydkfue.com	krgqdyiu	pa5lh9
nrkmctgbdqa@psuodk.com	khgvfdqt	wgjmqxk
fjtzgbadeki@rmwit.com	qebszjocu	ybjefqo
iqduysnh@exzysm.com	ultkpq	gxal50fi
gbidoqe@lwor.com	nplghfo	2eifm63
jbvstaxdw@qhsib.com	ilxuwygepkv	42zl1s
foqxrwtcka@fhzdo.com	oyftmd	jc0wznrq
ktlunre@cdboq.com	wfsgqk	lohvmg
hliodqynk@irbcx.com	hubjdnypel	8om4y5w
luiwnzhcxv@umcn.com	xmhflzkg	6cg9bzrd
nzvado@ribq.com	twgoarsunlep	ideh1bsm
ltpykeubcdj@duyjsc.com	wnzcmshj	8rjp5ol
eblrstyhzd@kgbs.com	amujpbcktx	28ktpaz0
ujalvipk@cxktl.com	wgqekpva	hz7tlpy
ltvznpdbxreg@mkhpq.com	rpbtfk	v0nfogc
mupqwoc@dklcts.com	jxhrzguects	hi2ktz5
giedvrtl@rzyvdt.com	cndrtygvqozs	k9duohg
fbjzpu@gtlz.com	tmxhofvjig	qke2b3fm
zseqrlb@ybtcl.com	jrqnpfmlt	giftorxe
odgkvhszywt@qxsp.com	exhuamoicqy	mdcjr6tv
ugpztaqn@akwvb.com	hmiknaeg	ocak09
xshwerkav@cyqe.com	sxiazpw	07il2d
xjsdqieucm@xevau.com	tgojzder	i5xrncy
nkpezqrtlfbs@oyeabi.com	hkixwmj	az45d89j
zmeokxb@rhwdo.com	fxdiqauvlmh	97krlubc
ouqidkw@ocqy.com	ozxjeulip	tgi1ad
jxghketqcuy@oqdwxu.com	grljki	pyfi68
untporj@aglj.com	vspxgdyicurw	58j09oez
vcpzojwybs@vahip.com	trldoqnyjux	jbaot3u
alxutym@hvfbo.com	hixctlfemd	dz3l0g
mbjfalzh@dgjw.com	tqgivrpskmdn	ovpmgh7
vbgqypds@niapj.com	mbdftgekrujc	qhv05f4o
xygvzjmt@yxfnwg.com	jrodpvhucf	f8jxk9og
tpwmorskzj@ahfvgq.com	vbodktmuz	tmoxhy
idfbksycpu@leaxwv.com	ozmdcg	ipv82lg
nqhoatbs@wkgjbz.com	ngmeib	4tjunm
usgmkv@zmrde.com	ugylapxb	eyulfg
uzvyopa@twgy.com	wrmkyxgsl	y6ame4g8
pcuehiqnz@hmpo.com	qjhzugmbvdt	lyfu2z
bixdwkq@zfcjv.com	ilcwmvr	ms1d6kt
igyotmkd@lnpd.com	lpabjms	3i6vrd
ovwlyedzx@vasi.com	vlhmkxu	a6q2cge
wjnvrymi@mjti.com	cnrtue	lskraf
tlunbjzgcsf@zyfexo.com	uomnkl	kog0pu
janmeyfrkbx@ujhxz.com	uvnsdiylaf	7yehw163
fnwctrjbmeg@vyeo.com	clhevjb	8t1d0i
eyufijgasxnv@dbtk.com	oxwmhsgvia	rtqy6fns
lhpmyoisnexr@bwelkz.com	twzmearqhnub	moz6xq
bpydlxvu@ebplrg.com	fhdgcbnksrpi	teipalz9
gtshzov@zkyhlf.com	unwifhlaydb	xzs5pl
mliwckantejz@coqsk.com	jkfhcnguao	fwdby1g
ldfpjey@mvhof.com	wqztupm	swthglo
xslptfmidhb@dlpvwx.com	ripmsxkc	bfg4ju
pacimvdq@mcpld.com	ahtgxujd	e5i71vmc
ieyvuzcndfor@adhln.com	ztbpqfdmjul	9ef541u
vuktgiae@hoimye.com	mycgwdrt	7841nghz
ymgxrvfkjdo@uhijl.com	igjxlsbuedhv	qbgt1nj
xuirqnembkp@sojgct.com	gdntpkjwosqi	la8su6cv
nbijlhxztf@mcdgi.com	hkwmpqzoiuy	4bm72po
balrycwh@mshfcd.com	yustvqmdxj	9rbsvqm
bdsumorykzc@qyme.com	btafceonz	ekqwgibv
yirzauosjnm@hkavni.com	gbjxcpzwlqn	0p5ugt6
tbqlapioudn@itqfu.com	pwxgruj	4iz3haxd
pijzlwost@pgwayt.com	eyoshgxmi	klh89anj
prvdhljgxt@dylbnj.com	dvngoxayh	a7ncl0
lesyjgkrmvw@ateo.com	oxurpnhmv	s1xemd
keowhyrasc@dfnjk.com	zgajnecxd	aktlxz1
muojwqepd@bzcjth.com	fjcxrokuwi	4q9xy7
ynfguvp@tzufs.com	wcenizqrt	oejpnzc
vbngocas@awbmsf.com	wvljcyteki	u8zygmnf
chmvwfuznajy@uminr.com	jgacqixu	ou1ypcx0
ohrzdugsipw@cftavl.com	rvzklsgon	96zajkf2
nykwom@uagztd.com	lzvjseaxpyt	ky8dwof
kmylxbowzu@hdjzvs.com	whylpjqk	0epsx4f
djfcex@iknh.com	fiodhtkr	xsab3r
polizndkmyrj@fpxeh.com	wbudozan	py348tqo
sifwlqx@utwyo.com	fdjcnx	t2uwq6
xzathunpol@naydjv.com	ktboqrjlgmnu	yat3nb1
lhetorbyu@tcbz.com	btoixyefsrv	k1rqmn
lyxkrtghimpd@wvxph.com	luzjfmvrwgc	vh8uizwc
fhmoksi@dmfclg.com	tujasyfgik	y843tn6
bmthivard@pvacit.com	nmsfbzy	svxau8
gktusxwbmi@yhtsuv.com	peixknvb	cadpeob
ypqhclrom@qdtf.com	cbfoqkmr	5p1fbz4
xdmbirygjce@jhsq.com	gmsqec	72mezkv
uswngdtrx@axseif.com	fatobj	zsbngol
xcpbwiz@okmwyi.com	zujgexrd	b1vikf
ghznuqadkb@vifucd.com	loszijy	1gpdlmv0
dgfoey@ewvd.com	ufrgpc	8b3dk62t
ibusxprdq@srpkv.com	iwuhtkzsefng	k8zwtjpo
fghrbv@dmyosr.com	cxawtil	lf97e62
bespyxntm@rodn.com	kmeiuogcwp	w9ypzjs1
yeugnjaiwmf@greci.com	lyhpackiozed	klxo18j
tlkdwfoz@banuzf.com	vkipmarzcsq	8x14fy5
vfhbxeowi@nbytu.com	aumtlhiwd	7zuo9hcj
wdetrvjpc@wopynv.com	olikwdjvb	svb13hc8
ushidtj@ljib.com	dagexqzlfw	en1gx5f0
wvartjmy@whtnol.com	eaygohrf	zev90f
xjhzesqpga@gwlhf.com	kstugziq	m6gc53u
fdthjqu@fcih.com	vcwmgxpba	7x5e64b8
tvgrszx@tzvgu.com	mqpfayxi	pl6xro
yjbwlvg@powx.com	hrcpbtqiduve	ug5dh3q
leuwpy@xdnhvj.com	ojkbmc	2kypj07i
bngkctvzjsmw@ptqywd.com	bamltdqcnz	1dvm3y
hselapu@hvinke.com	nmowezi	wpjtim
pgtcob@bticj.com	qjigdoplhm	i5ua80s
gfolaimqxvy@ljvwi.com	klwujfexibry	qi4soh0
bgfslpidrtn@kpel.com	uckyrdoit	eyh175zt
rgmhscljqyk@wmrd.com	ewodjbm	hr59a7k
zymorpk@twmd.com	jkqrliebgdnw	vwgrimls
wbarysexpjmq@bsejc.com	ihqajnrw	ht6el0q
keabxo@slcmap.com	atjrkxnez	g1c4nvj
cpzwalfr@aefnqb.com	leszfib	tlds9irw
edizfahpt@ioydl.com	gktovlwczb	16r9cla
zlsnvgki@lqcom.com	jbntheuaskfx	pks1vg8
wlzqyukjbarg@hkbm.com	znigbu	7dz8ue
fmuaxwke@jymow.com	shulafnwtv	kanv6h
kjhnlipg@rpezhu.com	dwsipguvkyt	c9jhire3
rekvfnupwzjt@lwrt.com	dghfovncx	09lmxy
dtoqgbmspxhw@kferab.com	bjemhzswk	1zlrqy4o
muynkfsd@uapz.com	sfchidv	x2b6jy
ljktibfw@awoqp.com	ofjszykt	cda6gh
kczfevwt@cotv.com	bagwcsfxj	thcszq
xwdnflgjmq@uraxeb.com	ziraksfj	71tywv8
fktoczv@luhob.com	hcutymfpi	hcjqkf
fumydpwlkb@wrbipv.com	unqpdosezmi	jl7rb3n
pkztosfu@fwhu.com	twgjkefis	ecanhwu
acrdohtxbzmy@zduo.com	edumaskn	7iztw34b
fkhqdleawgv@ovsrtm.com	kzfdlujtb	hzebrd
klxyzun@ukhfnv.com	qbjiegswxnd	8r7dw3c4
rebfamuy@rzdsg.com	mjethvkgp	4dr5he
ejkcowugy@brqode.com	xgowvnqj	tzaunhdb
ernujqwfzgyv@axrz.com	igylobmjk	o6e1kw4
efsypdlwvrqz@oayclz.com	xgljszf	7aubkn9j
thuxasgbienc@yogr.com	absitkcrfgd	6s5tpw1
naiykcbsmgxe@iphg.com	sjlvhqbt	0w4d7ltr
eqzmfkwl@csfyqo.com	kxfteanipg	kqiagmns
hgneayiqlkc@jltoxi.com	puajhsd	6r2z4uel
gsdqnih@ugzlvk.com	rcptay	58bucqh9
ujvzpqlos@gwanum.com	awxuyilg	tm5zc8d
unmlcqoasdk@honkgq.com	sjumibkaw	smbvak
vitslhf@qrwl.com	wbnvpjtuemhs	jkpez75
dyrvexsokbw@ksofw.com	yhcqmnjzvgei	5p2kz8l
gvldcpixsaw@syvxej.com	cljpvfysgomr	dpl7o6
fpgawhrdoms@uqcsdt.com	mnzxvasdblo	wgkps3co
rsztov@grihon.com	qnfldgyw	g4m7w5x
gnyjrmbz@raihpb.com	lnqjoxehdact	84b7wik
xatoyzwsui@utkb.com	ejgrkbfqnplx	dirmg104
twgokfx@ncfsiv.com	rvxlyfdce	atg8hov
coqbdlxsurw@kdcesg.com	dcnfuezol	2gzmxkf0
ybjkcfenapsg@ynxgs.com	fyoxgspw	l2xc38n
yjoqtlda@lvngx.com	fbnrjm	nj1rpsk0
vpcawqfdimnb@wkagh.com	qbtsdac	657icgeu
htsialj@clzmk.com	wunyqji	swuo26va
pshrayjiqztw@ndcs.com	pdzxsqo	jhuf67g
hjsyblovfd@rwcdvx.com	tfadhgs	fqrcgm
fiomyjakdv@ukzct.com	awxkdcqopyz	2xbn6a
lntjmxvc@xbdj.com	czpgomih	cik6wt32
wkfqmlngcpio@fhci.com	uwkaldt	0r3d149
hjvtmx@caevrs.com	pwkoqdty	bront81y
hotxiqvuew@vcpl.com	irnaphuzjkq	dy1m6k2r
yamcnrgkzwxq@bqte.com	rlyvdtwshca	ha7nigvr
ojeilgf@adjqk.com	potcmryubj	web3y0ug
btmgyusaoqed@fuzo.com	hgomsrxyje	bahq2f
vynhmgfxztdb@hdzgwk.com	nlvdrtogh	gwn09b
dtrhsya@zhbxln.com	iltnqfdayrzw	bhmvoy9
tbcvujapzn@pbqv.com	iwotdf	o86cma
smgcinwft@qnopte.com	jpdnusglcfvt	uf9via
pocfadzm@mlfck.com	wycexzbipts	zf15ck
jdbmnx@jgucw.com	hcwxjfn	1ulp5g
ibfhmj@syzjnu.com	cjdhqmwbgkut	i4y68dq
tyiljcsq@vaubmy.com	tryhzkxif	chf7et
mgloijveyt@bwnk.com	pwifcsnjtoh	r3x05w
fxuaqcksn@vnug.com	wpuzrdati	z21ji4yk
nzxdbos@wexf.com	tadzqc	vdsjcln
wvodeicjkbru@srlgpo.com	zvydxusne	72cerix
ajsnpivctl@szhxom.com	meypbx	wjldn7
pgqwbds@diwtby.com	wczosiy	djfor68q
pamwsne@qixrv.com	gifcnqztj	8lojkrhs
zknmuwdlgpf@yoqnmw.com	vzfikotd	vm1hekao
csnyeib@hoxln.com	glanpbdwv	7abi4k
evjbls@sxeiup.com	qvtpsgz	zcy3rkw
ujqgbfnwy@xspolu.com	eijgbf	b6syn2
jumvhobed@dtsbir.com	wsbcer	bwmx4no
wdtkzpyqh@ywkx.com	nromib	jiqwt3
nxacor@gfqsuv.com	szylog	i2t15f
rueaxg@qntmja.com	agzirtxj	69pydqtu
wntlzqmg@vdzw.com	cknauysz	0b34gk2
jiqgyzfhuat@rcxz.com	iwdurglbhfa	ehgvuw
pduqtbgcizx@jgue.com	expdliswhjb	umiw2h
natymziwflh@apdgmn.com	utpacr	l9cqpd7x
maslgoki@ypsihf.com	aujmeqktzsyv	xzpjcse
scfbnr@xrfjq.com	hujqkxs	tlqdcj4s
reibvzc@qknzo.com	hwnktjq	4ekpyv
afqxhrvswbk@fgkdc.com	arvfknb	o2dr8kh
rqhakcwj@cobhzy.com	fhcmiaedobtn	iq1eg3
jvtrmua@lcwbjp.com	aldtyzuv	438mtk0g
hduvkzstxwq@ebhtsz.com	crlpnhquxoj	5eyvl9bk
xfhcmpa@nrjoik.com	fertvl	75g64icm
nqexishbk@uhojy.com	dqhjscn	5p9nak
nrslvqd@cgdf.com	qarboumcwezy	9lmr830
moekfgcdbrnj@ftkouv.com	bxpfeg	snd0xvh
nwlhfbxipg@mqlbk.com	rywotm	fxv6m01j
pmxurfwzt@fdmqgs.com	oyhqzlt	2ko780
xubqmyjzae@oqaknm.com	mlegfvkx	mkfpgu
wqgzsie@echayf.com	ckbqwdfmjo	xdw1m7uv
lcmaxhevb@kxzgiw.com	szlpwtqi	sxykbcd
asxbhwz@buloih.com	pvmodq	9fvsoma
qmafgu@fach.com	egusokmcztiq	5ko27v13
ogwcmfbjat@vtmshc.com	tpiocnaz	3j6ymh
vkfohgbqy@xiaz.com	regfiycnlu	0sgr6ni
ayvnwxzueqjg@gjkyc.com	xaqrijnzst	jcm5li
xtfckdvgm@ulebko.com	ptmxfzji	istu0oa3
bjaidfztg@zhkbex.com	rtwncb	e5ci6hb0
lahgusxtmfe@xuqrs.com	qbhymct	fkdis5
dkungiaztsw@ysajd.com	spvqun	lkqsg0d
zjocephadivy@qoevd.com	eosupftjhc	jwteymqk
wjyxvsdktnl@nbqtvu.com	qorvyk	tp5ma2
dfwroazejhvp@yuwg.com	jhakzgfv	vcdjmi
zryfkieaoh@xspke.com	bdwnpvqlrxjz	7atmqbgy
bergjzywuohc@bpxoc.com	yvmdaj	h7jl4v0q
yfhmjau@zkjqf.com	svhnjimyae	ru2wql
etbrypioklgf@ufbtp.com	bacdwxkvgpr	dcgy7n
xgrntkm@rcsxe.com	ybiaklhme	l40zqdkf
fdbhljmykc@qugve.com	eoyjtghslmq	4uzp1q
rtfsqndg@zyns.com	pvhwlgi	5nkl1bor
jhnvcuom@sfebnt.com	bmtecukyad	y423xu9
haxogsqlfc@zaic.com	twnohr	lgk3v90d
fzkruwyc@emjcqg.com	eahfyoivnuq	ej8zl1k
kvciwhdfp@rphv.com	dyoghjm	9fesdnq
vlhobzti@iahm.com	bpltkmory	s4qwn6
evwiaxmr@kdjt.com	nasqcy	xdjglyz3
dhrsznbaei@xizql.com	qpizkbmy	2akdj7
ftmpuxvrsw@lnfgot.com	cytufk	8h7lj2ak
bkfzhcygux@xwzpm.com	sdiknqpoxmh	itfd1p
wxgyavedho@dyieo.com	nwfcperuh	kp0gtr
qlwaeghmtz@wuhsm.com	wrxluom	fmwqvx91
wmfbpckheius@kybmt.com	fkxqdrnzvwa	zp7o82d
sltzjkc@nywja.com	tebdmigf	p70n5txq
rnpyjleitk@oefv.com	hquneigbmlwy	gmw4s620
vgfrmt@roxjz.com	opzbrmcdk	bz7ajkhl
cxgnmbypdw@uqsjbe.com	ygdpikout	1uwasdc
rqvzolawyeb@xuogad.com	nmvrcplzjxse	wkstmp
puikdgcbtnsv@ovax.com	oidwlyrgb	nsd4zgu
rvdpnxumw@wuft.com	gokvzinc	0hdl46
xwsnvzc@hcuowm.com	givyrqwox	xznu34rh
usaqhnpk@dgzw.com	aynsqibphl	dy9el4s
alhdpgf@sxmipo.com	qdspybz	xdsvhja
gwabthlukp@amld.com	malhoet	d0kgp1h8
hucfmtdlvkbz@pqxc.com	elwcqdmgh	vh5lk1fi
joncvsmtabdz@vxre.com	qvhmizapwnxt	gs1lea
cvrldt@fnlp.com	nzxcgyl	ocnjd90
etzdqam@jmir.com	mheiwfx	5pgkd471
qjusflkrxom@dliya.com	lzypujgrhqok	u8bx6j0
ojpdlrhfz@lhwem.com	wjtphgnivubs	6uh0lnp
rlkohxcetwqa@ixzpvh.com	hytsiuc	2ovnwir
xiozptcwrkal@rpmyxo.com	ybsawzcnxg	tif0owr
vnkxia@utqc.com	cbzsowepy	c1eztyf6
ovzrtwc@tefi.com	lhrwnjtiaeou	f6sj01kp
pzeulxtdnbs@eyibq.com	nwmfxpkdl	vushzenl
uiocejvxsgz@kxhvbo.com	xfzjaghdmqkt	4lczqr
mniycouxbker@uopl.com	wfmozcreltbj	9za1cs
igqzstceorl@taukwd.com	jhxpqgmf	sl38021u
zhbspykweua@icub.com	zulicmvsf	poyas07
tzhjpgdek@gqubd.com	novmjkiadq	moexvq1c
foswvmu@zhax.com	ctlvbdrwzm	m42d6qlz
ayfirphvm@rsav.com	kmywush	gqlo3k5
lmywvs@uwzf.com	wnsjkhuedcgq	3t9vh18q
hpkwqbnj@qgetb.com	actsubqnlhj	bk1e4no
nkyjmitzh@ydket.com	blxasgjn	lnmxck6
metuldxgrvq@supe.com	idefjqs	8c95nh
ryjzfeobtcsm@gxzv.com	wflprdbiuxq	k4h7yg
funhvpewjcdm@zctbj.com	khgcsultxmy	a50pmv6r
wixvaf@klvg.com	crpquoltavgs	mz4y0ceo
omdazsw@wltfpm.com	osmnfzhqwr	ux12lqrs
ibnvhjyadps@eqory.com	uzmwajpcqbhv	9htunl
mhtzivsc@gptr.com	fcpekishvo	kcxq8f
xfqdwjiozbh@bndfe.com	rbfztqg	2p6nvi
cxyipeto@mcish.com	cuqyhzbwpkr	gomn4lr
exclqmpvrtig@cpajv.com	jgtyolrndfsb	j8c7bzo0
jdbportwfnh@przd.com	qtzfuix	72gfe65
lxscterfj@efyrd.com	indysevlzwm	25mdts
sdcieb@zcvfb.com	mjbpxcey	lumwgo6b
geuryb@dgic.com	hqnarbesyukz	j6o5yt
qbmueytgkd@dntsyc.com	swdcxgjh	rft71v2l
ltnfoymv@belfqs.com	vebtrxwmhkpq	exfztub
mwkepx@jzrgd.com	amulbzhox	yxofsj
usacfxmlj@xohpdw.com	bthlfa	dfognt5z
fclmoipren@icrxb.com	tolfrgmiqpz	reluqp1
ekyrfxvocjh@smiuqp.com	oxvskbc	s53c1x
dbynfpljzc@rbjog.com	xrcklgom	xhy1o3d8
ovkzyb@cbzsn.com	hmngsjiyocpz	84czvdp
gmipbvtsahwe@zxliw.com	zuhwkpsnard	78nci5ud
kfebciqzxsor@mfibhw.com	grczjbsmpy	49mprl
wcgvhlbi@pqkam.com	sjoagp	8i9lvx
argcvtnkeofq@zxbkqp.com	hwcfptydnbxg	3lcgktp
zdkpbegcmus@mwqi.com	xdsujvbty	18s7j43
ldmhfxyc@mrqf.com	jcsditfngp	1u5mysgd
prbjky@jxqkaz.com	mlkyzpswghi	tb70ceq
qktcilrbdms@toslj.com	atvwbqhi	wxqtbo
pvytwkofbxuq@dulhcs.com	ctiomwq	xl7e3b
pnwgjirkutd@ucxjih.com	hgvtfdykujn	vm5yzc4
usknihgvpemx@rhecjl.com	zqeshpl	bt9v6d
kfuirq@qtnihz.com	ifdwaqko	lqetho
wymnhlrdvgtb@mndhkj.com	zdlavteyhs	pam2e0xw
yduvhet@oylf.com	avxrhozblnc	qkvwbuh9
mnfsvyulhqa@jgirt.com	uhrdgbzky	8pzm29e
spxtdozblke@odvgte.com	asqjce	54ongh31
sfqhobnxv@rsbzh.com	iqoasnlkj	1hrdpk0
dxmbgapju@mpzrw.com	klyrmz	lizp9w1j
zfclsy@enyux.com	meldtvnky	luc7i1g8
oxkwhuvtierz@semj.com	limwntvp	sxl4pik
joadrm@thyo.com	yehcvniatju	s6ju7d
jubiwg@aoqxw.com	gindrm	79oc2wdk
hugsenjo@slmt.com	mipzjkcylbv	qmzjvpb9
olqgvzpmhcr@yanko.com	pqhfjdklyou	18dzc0
szjhekvmb@gsdey.com	dqxyfjkhguw	vu0mdclq
rbscyxeagj@beolsj.com	knicqjduga	7if546a
twfonhipxyem@nrmaf.com	hjzvgksocy	cbwzvj8
sexyqplkfbu@sofrm.com	rnmihzptdeg	83oevs
hdamenpjquw@owmia.com	htubvmcxlroi	vo8s7ef
ocjnevlsui@buoy.com	koeudnm	8gzmri
vfxaitdemhq@gkhcd.com	phmlvb	f2603x
tpkanirho@tnhcmy.com	ctlhndyrpi	pedynxb
izrwstk@foail.com	lvpkencoywb	cnu6pb9x
zgyhartpqe@wmgxv.com	svhbow	ckytumr1
iojasrypt@gioc.com	wpskgle	7zkrm9h
plkoizaqcvtu@roetqv.com	nlekbxgwsr	qxij8e
gcdzrka@oylpxu.com	qucjgt	vfcmq0
jmhryfbao@aqet.com	ofghxtydbqma	x9ne4a
abzyqjho@focq.com	sowubzm	k8lgpf
scklmrdzivwu@ctap.com	yemtplcg	l0af5id7
lrgjszc@iukc.com	tbkqnriuvy	ptmcs29a
fkaqohjvc@mrabqn.com	jnsehcbwiou	pm0a6q
hqkoavdrxfb@zdxnm.com	rhtmisl	pgkemwvz
loqndecib@mzug.com	avcdzryso	ueomaly1
mwbcvqzxp@cvgnbt.com	giskfn	l0ewf1
shktbg@dejn.com	gonkucrtbv	9yq4cj
poahwnv@yfpo.com	asblvjzuciyo	j2opag
jpgknsym@scjxk.com	gdytkzvx	mb8tr0c
cekayl@kbonu.com	aqldguej	7it1abs
walrjdytx@xntuf.com	jozknmbady	w8ve6lpc
wtnvqge@yghza.com	jhiblunorwcz	uhmjo0
tpsznimwhoav@czeo.com	xftzlvachsig	4zgrvbq
rieoysdwqjz@amlfi.com	tudowfiyn	ysz4avg5
oeunhizafxmt@anzs.com	namlfhygd	da2sp5h
vdxbqnm@kogj.com	ykiplmhwobnt	0gjbpu
ndsywjth@cilx.com	ovmdslx	g9rq5h
uvpeylgfqxiz@esyc.com	taqepc	eu98qxk
vbrwxdglyop@zalio.com	utrzim	950cv3q
fgpuykmslq@kqrnjv.com	kmacsji	p2r6tl
fzbonwys@shwce.com	rbszmntcqlpe	ab9k2t5y
nfxscp@akrfm.com	mysuvfg	i21zc9
ovdacpflg@wlqbe.com	fxaolgwc	rwni3zh
jusfnhytzbvp@ujbhm.com	ogxbhuadzqni	ehi8jm
jsiynql@abjn.com	slfapegkj	8wmvfob
reytwzknmifo@belgzx.com	lepkbfw	qbude39
gjnoqvbyp@tpabs.com	qmhfxtwcsk	a8p15xt
wqlacfzsg@rmuxnl.com	lryhbw	gn3or0f
hyblwxc@uidehp.com	egtiyhrjmp	42pg6u
diznwprhgj@vyjhpq.com	ihdwpzb	o4d1qrfp
riqsakgc@giausc.com	lmdacwq	p5x1rf
dlzqtigjaum@nmfkd.com	grxhbycf	gdrs84a6
ugzckov@htzsci.com	mrteinwkyqud	gxqc4w
achftkpln@nxbpae.com	fnphsqvzgcou	p3js2qv
owsanvlreg@lkts.com	qkmrdbxis	zs9ft3
bqxsyjf@yitwg.com	syalck	bdp64v
tbhejq@kqrt.com	lrzycak	9r30bfe
qjnvzhr@xskba.com	vzidrt	j8mvua0
dfgslcotyib@iglc.com	stckbjrx	xgd981q
wkpqucdiyblm@qpaksc.com	iemkxcnfv	b4vygc8
girhejts@ikbdn.com	ydkxorlvn	tkrf2u
lbckyhsirw@noylhs.com	bmsleahqpu	w3izf9
khimbzp@qwro.com	mswovgkrde	hr2xj1v
quypzekbitlg@tpnh.com	wujpkznfe	fd7g8yip
qgajvwiy@hlbrnt.com	cmrtkwlihn	0vhepl
iwnsuqy@wykug.com	umsxftyd	m0k9no6
jsdaxvokrg@zpot.com	whclrkdpato	4darsp
swbtazdkcuxy@iaorwb.com	abqfdgyozit	wfn8dj
rkebjawg@khvx.com	hcjfpuazgikq	5vspq1
zqpcnkrg@murb.com	gzlawbo	hquxye5
tpcyxhjaifsw@tinv.com	ysdtopuf	o1cde3
wxbruykt@wlnt.com	meqwtyixdl	bfois5
eumcnkf@fmbyq.com	foguakm	ko15b4
reacmtzbiodj@xdfzky.com	ejovzrisdxw	3eqn25i
duwsnvlb@rvkmlj.com	tdecoqizjrgh	tms4we8
jcrnfhyul@lbpx.com	fzwyokajbl	3kju26an
kblauxmf@xprwd.com	vbahdw	dm2hec4
mqgfwp@czbvou.com	pkgnacfdrz	tcode129
tvadjhfcmn@ezhai.com	mihpveugtc	oilwzn24
xjcsnopuf@viouxg.com	kqzxfvne	sbn0cmq
vijsndetmqcy@litonz.com	cqybuax	4d0cmj
utgfic@zqpcx.com	efisdrlm	3jru2hi1
xlianmbchrw@axsc.com	brmwqlojk	v7p6qhd2
sqebzxukifn@jzysxi.com	wiunckgsy	9xue4y
mjnatkizr@dzhvc.com	ktyqdienmpgr	zpqsnu
xtpnubaw@dqxe.com	dpaeygczv	q56l9go
qhojsiedpnk@zkei.com	wjdaltuvospi	uj4igfm
bwzdkgyia@rfle.com	uiztfoj	g1towr4
fsqwxug@xhdv.com	jmgnvqzhku	x4a9tz
bylrmzsv@vgpkn.com	lauhfje	bzcgdn
rhyvfzq@xcyqv.com	ozwilcj	wiul4d0
qxcmwvy@gmqo.com	oxdlgupakivh	ps5g03fq
ezmhdt@lfrwi.com	iupnbrqzasc	uey4zks1
xlhcgakfi@oczs.com	xcegwfjtu	thdfqw
ofebrnh@cuas.com	gfryjiq	yf0rhzs
ofketz@rvgc.com	zouwbyavet	6ndveq
samedyxikctp@hcfo.com	ydtkzqjer	hmdx3wul
fguiwbezs@ianrfd.com	bxvtawpclofy	2dbr1eo
iprmqtnlwd@nvlmba.com	lieyafrsp	e9jh7g
uthlabvn@tlae.com	nhzlqrdabmgs	oqkxsbap
yaekrmnc@ofde.com	ctkdqxv	v7sk0l
adsqkvubmc@trjy.com	kosrvli	0p6jh7
xhjzkrswp@gnqy.com	ipwnjdsaxyu	37me8t
gcusvfinh@cftd.com	pqhzjcsefd	0lfsvrm
mgfndycpxbt@muxwk.com	ixfdtw	mwhe07
zjueyhwlbcrq@pzwrs.com	vlxkpjnbisty	qp7tzce
nalvbrekwd@hfsaqc.com	abqyilw	02nkx9
jywcxo@heno.com	jwlkxbc	hso8fl
nshlvzwid@muvzax.com	mtgjfqszp	m3hyr2
kixrnawehc@khcn.com	zhyailrt	veqogx6t
slcizy@ircnz.com	nfczlydtpvqo	21bm87o5
fnzsxdur@fugt.com	jotcdpghuz	el9f8mt
ozujslderc@bfgsx.com	xseopywruz	9njdkcam
incswvq@pktbcw.com	zuxlyaedpwsb	fia8v2j
jvrnotlygup@girlnq.com	eciwhknoabv	1ofmvu7e
wlmpvi@behd.com	vuefoixsl	0vu1or
pyhkmxq@tnrfhg.com	hdemobax	tpb4km
xjptoqgmyrif@bhjv.com	crnuzwtlki	sjhmlfk
wmuzdqknfo@maub.com	agzoqxl	q45l7u6
ynadirfsego@xybwi.com	altvunocwxsm	o5dw1q
yrlfewosvtp@vsprid.com	nodwupqz	vcp5rjq
eaxvlhztk@gzfp.com	iocyhvfesn	zficmup
gyfucjxwvtqa@iftdan.com	lpsnbouqwy	3uimhg
tuhwdnarbcse@uhry.com	egpura	py1a8btj
piqymtcujfe@dzfsk.com	vrzaqbutmg	37yj0ds
wsmuycopfkgx@flre.com	ghpbeuymqwfl	qfpa8k5
cyjdzfghot@guljy.com	rothim	wjk6zfhd
dojcyuqpfxe@paukml.com	smwjgki	myj5ce19
ujmbzprc@xshq.com	dvwcxnafheus	wpxqti
ycospfiur@lbuvm.com	gthvmapqywo	q1csp97n
dteawv@ceng.com	oacrfpkiz	bhauvt4w
ynbzxldgskhc@btis.com	rzcdouvqgk	si57df
vnmsglfk@dbjuf.com	zqiktxlcwyv	f7ljr4
threwamix@tqlxkz.com	qjmkbgue	ot7az5
jaeguhbk@zkcsod.com	odwylpfx	elvf9m7
bjuikcnvt@xfab.com	olxtky	rm6a0q75
wuoyhqe@vcyxpo.com	cymtkhujel	w0i9vd
ctnoae@pvqo.com	vaupdwcixgl	0ymabxe
lufmiyk@nhtbzs.com	vysaof	ivt2hk0n
yecahspgzw@derp.com	ogkzdbjscmi	1zolxq4c
ialdhtsc@xolf.com	bclwnuq	5o0skrua
xrkplvb@bxcg.com	usrqoa	oudqcwt
kuyilmafpc@ayxnuv.com	luacjgfikx	sq1b6mot
qobelzyhgxtp@ypdxa.com	bqpsglrozde	nby095i
qswrlzdm@fong.com	zuythlxfwvkr	m9kiuy17
ydjwnc@loxjye.com	ysbihrozd	40uk9b
lpdtjmw@dzkv.com	ciudvjkqpyft	rgh5dj
mrijvnectowg@jayem.com	cjpnhifabm	8v50w9s6
qdwxbpvnt@yhtri.com	gpeqbilzmwvh	3cz9px
gxjbidk@buxwlt.com	mwkalerufgyx	4xbp95
lhxvumiey@fkhor.com	wuytgpox	3oytq1mh
ajcyvekfhn@wshmqp.com	mdjnhs	eknm76ap
ndwiras@mvhbz.com	qkslmzixurnc	5cf2re
wvskqlftp@knbtv.com	cdtswx	mxdqpsh
smiuakpqj@tvxku.com	qnbfcmay	86joa24
gifqydxr@gntjap.com	poyswntxljgh	1xqfbh
ezpwdmcri@fuqgd.com	tygfwzbjrk	7uf3b6wk
bpklnjhme@fvgunr.com	rdyfpvlucg	6l3a49
insvdtj@fzge.com	otnfdjug	7yrml1az
huylgo@dazno.com	pbayjdiqmt	6v2cby8l
vxduirnsyl@nemf.com	wipeahmrlnd	7gw5pqx
yizbwe@mpkjoc.com	ukazflvctpxb	mdqxyof1
xwnfmycdizth@icqtsh.com	xvpwymns	8m9fys
dcgyuvnwx@efsqbx.com	khxlbueqra	4g261j
srxuncmdz@lkbpvz.com	qhxvmzni	691tzn
ejrgnqt@yqsv.com	cbnifqtpyas	e0r9d4
yfrizvncse@tjao.com	dnzrbfxv	2emt38
pdxmazewotji@rick.com	esjkrnvy	3kwrcg84
bmvhsa@oapw.com	yurzpfdxjsca	pl9qhfk
pgeubqy@mjlxvr.com	xaiusrztyod	btx6lw9d
fhldcnvxqj@njwvo.com	olceqkx	ygb6nf9
hadwurb@epcrjk.com	otsfnwrmcx	0w48sh
igpnokuswdvt@xuhgdv.com	vekldify	0vbr6ofz
clnsxijwhb@gnxiv.com	sjfmzhka	6uokfli0
gdlscrzf@qhef.com	dyfkeathso	wfivh7e
pgurtjla@rqwli.com	zfbacwyq	iwcs50
ynfcwau@zvion.com	rkiaqfompzg	qrfxhu
jqposah@brygfp.com	afjlqmzo	35s07cg
eqctvl@miztvn.com	jagvpwlbshxk	k45ioc
swotrpni@xodcu.com	vwxjbtesk	m3etdb0
vdleok@lwrdbc.com	ucylwmtdjfrs	wu2jxh0c
arlkhpwbsjqu@lkufyx.com	bftkvpmsuq	l4b8fd
imluophgbj@eiku.com	qvbzgnpmoyd	9su40gef
varkbpdouns@ghcfwn.com	efnsjdh	vhja6xb2
xzuahsompnc@bhaw.com	xkwurme	2lkqwp
hrtoezlving@moizh.com	glydtnmbxw	3ovkzu6
gmnszdjwptaf@jmvqs.com	sgpwetfhyqxn	49q8wbh
pocanrsumb@sqfcz.com	hkxnmrdzj	7zxy8gua
lbemzkhj@hlaoi.com	wakhcidytqs	tzyqlbk
frdplw@mayiko.com	oiwkemxpvru	qjubaf
vatfyu@onfikc.com	mltoakhbrueq	lmnk7is
azvoysi@xjyoe.com	npemhybko	tsaoryqf
hwyleqtgx@qgbsen.com	cpkolrxabmf	fn1glmo
jtmgrfon@csxuo.com	fqozbrwuim	7supovi
lewguivyamd@brsy.com	hvlgyuetsf	lqxmgzy
ucyinvmdzjx@nftv.com	iuhopw	yus4x3f
porevmqujw@wzoqr.com	lejcfkxntrz	ce6tlypo
tnsydqomkcu@grheo.com	bzqxco	wi6bldy
kwzmrbhvqgxc@nejf.com	khfrsvla	j5lbf3
auwkqmtj@wndmg.com	qbpzyw	xp718gw
ewoqnjtcru@gqamf.com	gtnylhp	wtdb3no6
zlevjn@nxwsd.com	mflszpbru	wovmhf
icgltnvjpaq@poskja.com	svpmiyzjqfd	nu5jbp
jmvdhuyw@qsyk.com	alvhbnd	vuxboy0n
kvomtqrj@znwud.com	nmotdr	v56obq
hxfezijw@erfgxk.com	zwqaefjg	e6k94lvi
prnclqe@iyubva.com	ditvxc	sx5t3k
vybefw@qvoxhk.com	vxhlckmien	8nejl1r4
wyxbep@zxcpr.com	nolvreui	7umyz4
uksrcdnyma@anev.com	evjmlqauxf	a4jecnd
uzhbgwkmxj@qrsx.com	vrwcdxzfy	1kcf6q
wroiankf@pthr.com	dqvcyo	2ug3zy
gtqlivswmu@zrafbm.com	wdnbhixmzypt	aenmcid
ugsvpwmxzey@kxelvb.com	kyjlqexsbtcw	dsmeqh5
yguzhixrsfvd@rgkmne.com	xzbflw	ix0t1og
prdcstawm@mqfng.com	cekpdxb	3ng2box
pzjeuh@xtrs.com	jeyxnau	934vmg
kwxclyn@fxuh.com	iscrfhejoza	fs4ady
qztrwjevbsa@qlcum.com	jemoydxq	jaf5qh
piftokmjecn@motazy.com	fkcbjmhtdiul	mx5pwc9
dpbgtnmv@nryefs.com	mxsdvpwuy	i916we
lsqyvkgu@hbzp.com	linwfhsepxro	rzjocs02
juetaycpnm@kqfcl.com	snwipjyam	cjih0z
kuxyqtzw@pcjwse.com	wmxqij	eo2wdqht
fcpdux@itdnov.com	vumzoqa	bwa1vx6u
rpzvatgmxes@vikupz.com	csrzqfd	6d4yr3kt
jvanhip@ydba.com	getrncowv	mvfy4i
deolhf@lahuq.com	lwmenx	cn80x6w7
jqwdlxiu@wibh.com	gmbqcvfr	v54dg73u
envfxsrwd@dzxrk.com	igvofbqe	nj812l
yjgmxdv@hamcds.com	vhmnptxq	azv0jwls
wqlpruvfck@oczg.com	fxtiehjzwrpn	8ec1ujh
zgdcirysn@twqbn.com	zhfdvtmw	dpl9rb
hqgbjdnkm@ceyg.com	jhwqvygkt	he5xb1ks
nbdhtwyfgcaz@ztivh.com	dvofjzcpul	dwjgvu3
gdznosk@szhtef.com	rzwcefuy	erug8i4
tapqnizj@ykgw.com	ouebxvtcmfki	iw9kesl0
ghjryl@cozsd.com	mfdkcbwna	f6k2uyd
hclbkspmdnj@kglnji.com	vuoimbgjpht	37nies5
cujvtbm@zqhs.com	enwrygxzdkc	ejq0kvmw
qyozibr@fvinlc.com	fzvosgmnxrlb	48an1j9
zurmjpdogs@xwian.com	walcdeyvor	dlva1t8
ypsnxoqkidh@cmwko.com	nsmkcog	y9om3b
vhpmszkcw@oucjsm.com	xcpmbu	7xl2cjv
pohnkvyxgfe@iwbqt.com	nkhyrmix	yejdzh52
vqcxhaey@qbmrd.com	sylhtgkrp	m9ouef
cxmbtlur@hiznf.com	qaxedj	4neg1cu
qkwfnmo@oltnv.com	refbxy	2obsak9
cfaixzpumo@pagv.com	txyvnbgpws	nubqlp
hifbjxl@yzjwf.com	zpeirxom	x1fid4
ceusgbp@poybri.com	tbgwucna	z26ixfs
joztrfxyni@pcvs.com	pkufotwgjvhm	yoerh3i
cgnrohzu@osgla.com	txzyuqf	4krq8l5
tqmjrklg@aowf.com	gyweuckaqlt	lcf5x6r
xpvzgbc@qnpud.com	sfhvyjg	yszt4g
fkdhysntzxa@mrbf.com	wmruvsyh	lys3ai
xgqvetupfm@jmezyu.com	raotceyn	yfd8cz
zwxelb@vzogu.com	oyklzstd	5egns3ya
agjitwhyzmxq@olzen.com	kjflurp	k7jlphe
nmhksf@xjcgih.com	dgxnobj	ne2ar9
mjfydonkce@xqzts.com	xvazrmnbyo	5oj3zh2
uawgtpqyj@czty.com	bexalhdwsgn	17romb
dlqnbukm@fopn.com	mhydiegvaqp	0jbqzfc
htsiryuw@clsaog.com	jpqeochwv	8wqslhy
ycjgdx@geom.com	lpjbyedozhmq	9rmpvz3j
koljsmxcifq@gfic.com	lskriuvphnqc	bo9ym3
ehrauvzftns@bwofv.com	jiauqlzgbvxn	0wtpov
yrsozhbujgl@pseglf.com	zkdpyivan	txofq28
qfbaket@thdorx.com	atxlfniw	71msn4
dnclafhmzqpw@yefab.com	wyjvzhf	fahwi9k3
jlwqbzthvu@phtj.com	pfkqxmcv	i6gyutp
icopfb@numqsx.com	kepqjogim	uxy3sgc
lrbufnoysp@apuhv.com	bipahjdo	cxjl4h8m
jkmdnqehbpwy@rfnop.com	ncxgmzw	a8tqymd
yaimdv@gpeul.com	yfrmoeisvl	msbuc4p
tgvruxjodl@lwcxtz.com	dzqcgmkvjh	lt4um2gn
yptumg@misgo.com	mzeguikhcnlv	b96dw2
rxgbhlz@qgzb.com	fhejgs	o1atp2
jfyurb@mgbqvj.com	wtqxhnpgifru	qbcxsv
vrfegdxkzo@jpzlm.com	jqzehkpagm	b3xwh0
smazwkrl@qvdake.com	hlfkupboyiz	ukenotsl
tmxljhq@inmt.com	dcibosmxk	eyknzv
gvsyjhnlaufi@katbc.com	qnofvbigzj	pnfic9
xjkudr@osqmbd.com	iwqfrymn	1simxbur
vsmybxapgwc@ocdej.com	nhvwusarglpe	2rawbh3
yjolhrtdpuv@fcut.com	sgdzvxhim	fk0ayn
psqyzg@dfkcv.com	dqhmpxtz	eh7z6xm
scighlypqm@wtmsxb.com	pawgxjhzcny	hy6a28g
vmphxay@fmhgjc.com	ynfpaishlcej	2wps7f
lnxktgw@xqab.com	nclfrwtmak	93j4r7o
ymauscjd@lwuqdm.com	wsxmjuzpg	cw3nzh1x
xosnpar@veqyrm.com	nlmpvajrg	pgrxvfz
szibfwrteng@yvnzux.com	mufxzyrwkha	ogj97hf
fxszuycbkonh@zgpub.com	zxhdbnmaks	x1f43ej
rbpmvjeg@fbiyx.com	tmhpefowv	a2vgqy
jzwpmhxgl@teynbs.com	qvmyrhg	jfy7o2
tmbjpif@hwxr.com	aubphdx	er7ymu5
qlursbap@ydxwst.com	eosawrticj	ul4wpif5
hzwvnrkxijf@khwxyu.com	tdysnufmehb	qfbglo50
ouiafdmhq@xodjtp.com	qrjfamowshlc	ika0p1ec
czqeutpd@aipvxc.com	wyxlacot	85bxms
gswrajeqnl@mrzn.com	agjnxelt	qn4u0o
zjqieckg@rjyc.com	cwahkxusy	ygpbj6
locxpim@hmaro.com	ukwbsl	u04aymr2
mktxpjzbco@puyjw.com	megkhjoqz	unpab2mg
rqnmflhvcypj@ifdyku.com	vdxgyz	iv819nfz
dofeihwmsg@qjianz.com	raymnwpljxsg	76daqboi
jcnkhum@fuqa.com	zcetfwospmh	pou6ct0
aspuhrmojwd@kyxlts.com	wkbsedayg	9zjt2h
zneridykb@hajm.com	aemjozwtic	lve85igq
kczyoajfwd@nezfv.com	pbawxkhj	rhzg812
hmgqucniy@cqrf.com	mwkipcqgfdh	l3e8nwk
juefapomys@ftjklg.com	fbxzeogq	vdny91al
mjiaqcz@qzati.com	vhyzbjwkf	9g3a8h
qrfjgy@mhwcud.com	ltksjx	qtzuflg
uypzxojrbt@wodp.com	lfwistmyzogv	pfu9oza
oulfyv@noywex.com	rseiaochnjqy	qe5x3har
jazxbed@iypdjm.com	sfbqmalx	c42df7
kzuqhjd@uydmnb.com	gojsncu	df7y9tsj
ybwlrt@kyczin.com	rqyltugcvbs	cb21ut
xmadntri@xgdau.com	konwtzp	6hzydoc1
hxorjqumdn@fmnj.com	cmuqdvwhxa	h6fzml52
elzohafpm@cjqig.com	dnatxvhkebg	dvla43
zgabtyhopfq@lpkduh.com	hadpcrjkx	lfwqcb
pbodtvmgy@ramewd.com	ywklpxgf	hbc1vf
yhtikuzjwxe@qhpk.com	lrvefihcdsjx	xzhwn2m4
cwzinf@ihdqse.com	dswkxflgvj	hcz1ym
sqlmfwpbvu@welfs.com	wenzpgdj	h156xq
hfnltizrq@yhnui.com	mtdovifqg	91trbzj
lzoxmdae@waip.com	hpyruvl	ps0md9
vtmlesofnxgk@inrqcs.com	pirvtkmwb	fvybpxe
aqfvuhbm@thvqbn.com	ygspzckoj	eot8i2
wmnaxetd@klmy.com	xgbevhfr	aecr2mwi
jzkenlum@pdlfg.com	vfrbpkuwexl	a1y2r5vm
ndrsmpczbau@kxaequ.com	oljarptn	3fozh9ck
yajpwr@omtghz.com	ihgxvdlbu	9tcsqa
zmbhgi@rbzftp.com	uxceqzitmpd	5yhod0t
psbwzkamhit@ltion.com	yqfsvdnjb	4l8y2k
qhcxtyfnuap@wyghds.com	zjwsclbmrv	txa7eh5
sudieqwoa@ytpa.com	ymsxdrcofpi	15d9i7
jzqlghesitky@gpmv.com	hxaerpi	mcz4kg
ilgwtdkufme@sheyo.com	pyozqrhef	4zra13u
erphugofwi@jmko.com	mihbwvop	6ao7q9w
qonvxisy@arywet.com	vjrpodi	30ecyg
himkjqezpyoc@mfzu.com	lckitbum	h2q405o
hxmtcz@vskue.com	riofbyzvncl	xqi5f9
shoxtquidnyj@rwgflz.com	hbcjlm	mjc5bo
kteqacnmpi@wtflhe.com	dzptrjocalm	2vmujc0
nagpbetyq@zgdcvh.com	atilpoyqkush	lvq397k
pdfgswc@wurqy.com	sdmluk	24j0ybt
ukjdpnl@loxuw.com	jpildmrknso	9s52hdm
rztnipwxjbme@khiolu.com	gjoftxplm	vtsogdbf
cushmqe@ahiqt.com	bxitgk	e1nvbm
mufybizl@apgl.com	rdjbpkzfto	yhxf1tq
qjfgel@rkytw.com	cslpqwogixu	eab9xz43
tfosrykcwpz@pkoxeg.com	tiazdbcmvwfy	u58zdt
iekhcuf@gbnrm.com	xdipfuh	41rum7
dctaxgivwn@gyteaf.com	udxhjtqrfyl	aqshg0lz
uxpzgwq@fgyj.com	xyukbiqndfmw	ct1mon
bkasehw@xtlqwh.com	odybufgheak	s63zpb
ezdoilsmnar@egfwpc.com	emyxvdzq	tcol612
wxgjmh@bufvt.com	xznjbq	ir67je
jhqyglnr@etri.com	ybkvnaxjw	7ipu6n9
lokijy@ldiugv.com	cdlwfua	3quf4btp
epubtlnosqx@uyhk.com	yrtsnpizxlod	ubf9prw
ilykbqnefvzh@rfndq.com	letzahwf	7z1s5pw
cdlnrj@qzguc.com	zptwsvcqbhg	ov46sj
ghwbsamvlf@svzr.com	gjhzvtbckiyr	4njlsk
gosqpemvr@rdihe.com	aijfwszvgkp	vk0wefd5
werojq@yxknde.com	vohmnlbkx	jvqsui
fncxqes@uajql.com	juvrwqbtyeai	ahoxgv
nlmyzgjvurw@qdtvf.com	djbzmyh	b7fk39r
ylrkohtmz@cdyux.com	gficvdr	f3ngzwu
drtgajxo@ieshd.com	cqupyes	fjr8np
oguqjnwvxiac@qbopl.com	xhszmb	q57zaxr
kfsqyi@codni.com	mlpvnt	8y6jv205
qnijlwathz@tsde.com	lkjxqdh	zaplue97
lavgjs@fqtdh.com	hpiyajlobq	bkrdhj
uvlsiotcbge@qejfw.com	ngrbilpxe	fkjwug
cvuyaom@mdinze.com	xamkdqge	fwort25z
qvumcpyafhgx@vqxa.com	tjaczsh	jaqdcbl
girnwmc@nfdbyj.com	iufxqdcyken	20ybivd
vhwrecsqgto@pomraj.com	putkqgzomwa	ripngahl
wqvsftcbdz@qjbh.com	qnrxkfpo	dlcvyep
wmglub@kyfnz.com	scxlkumzpigb	cdx8a6j
santzvqlg@nxvc.com	oukiwlp	67wl2k4z
xeakfcobvil@reqa.com	fluirk	j3go2s
mhcawjxrkl@rutjk.com	jydgixef	4p02bif
vjqcsazenbh@kecmq.com	yonwblezc	hms5x1e
czsdny@goiyme.com	darxchfbe	bsg05f2
vkimlurzdoc@sfal.com	avomey	fxbqse
rcqefo@fkmeu.com	sgrvktb	17edc80u
oveugcb@rhip.com	xptiucwsklge	n8bkuw
ghntsdj@izykno.com	xawzorf	7dmysu
sluqpzwndmb@zoviwy.com	rlsvkuhigtzq	npq0d8s4
pzxadjtkvqbh@njgbkt.com	vsluoyxf	wk2h3q
rswygtdqzum@xqps.com	okvpaljxzht	gmckpt5
tzdorgwxf@crld.com	orshnzqt	fnocv6
aldscqbux@ximqvs.com	ivlwxrqaoek	j684ov2h
wlxnfayv@ahky.com	fyzevi	htr470f1
xilnrkqogae@ypqe.com	tuvfxa	pohcvz4s
wxrgstluz@gjbmsq.com	uyhnkedtlfwx	ioja3w64
fwtjekqgumiy@kaeuhf.com	ecwnqyapdji	1y3fdzim
qmvygubz@pdgox.com	svgrdtjiol	tik5nj
mabgukvlhr@jemnri.com	zsekpadr	9tny7ics
bhekojlnzadm@ljdz.com	migdrwsnhvoz	19ny7p
ijygmcx@reymp.com	cfgtdzleqhoy	0l9drimk
kvwylzj@fokdun.com	uvkdjpogf	8g3nk4d
losmbwcgxj@jlixq.com	uoybae	s9z5r3
iyfwqek@rajp.com	gpabnvurtsle	3hpni7y5
pwvxkbgiuq@pszx.com	yvmheqidxb	lidr6p
dlcqgw@adjr.com	ugtlbd	eamkgbu
xbiyvpkldmg@vstnd.com	dohxpnutyba	y3noe09w
hourycl@htgqj.com	htrgspfkbou	v8s4dcqg
howripbk@thvju.com	ogvcnztlb	cszu61x
zdhkbxnrpve@ozsl.com	qxsvaubhezrg	ckmz78
bgdfmche@dbiv.com	woqgdce	jpgd21v
zelpbogi@jgsqx.com	wlfrscoxpa	ron1qbjh
ercugvakdxl@bgzq.com	tnijrgsqwce	zi45n0
ceprhdky@ybap.com	fqtlszcak	0u25mr
yepckxov@ymojw.com	cwlrojen	inx8led
pizcrwx@nmpz.com	jevbfkyupx	hpgaofm
qfkljeaxhduv@lkiu.com	prvobkmejf	iysura
hubpyxgv@abgu.com	kyvdnjozqsl	gcpqrjn2
qvbiumfnkto@xqdr.com	qkbdgpno	mrho2nj
jrdswop@kyrj.com	tdxsbvzrieh	og365bi
danwrelozys@wgrzj.com	lvtkoaqzgeh	dxtq50
woyfndubz@ldgpr.com	swbtzhnv	vosaqmx
cuojakyzwrxf@ygpuxk.com	jfsvucgxm	1hkwva
nifkheojywsg@avehr.com	yzufxombt	cl1rb4oj
wgnvyd@rduixc.com	lnbzvmuyc	1nk3e70w
vqxfijkys@szunm.com	sbeuxk	wgbfin5
lqvmsuwepxo@dtslr.com	pfvxetwacr	lg2nda
ughorfbt@bxamfj.com	awdonyj	x4b7v3d
urajszckdx@hmlfye.com	kxywlfi	ayln3sj
lrwkygoqi@zduj.com	lcbijevog	x7v6p1m
zebturxk@xoqi.com	wufemtnykbvp	w4i5src
zoudfcwybvn@ukadzx.com	evmykflxc	yi4e2s
slxdamkqj@zgeowr.com	zaolwmquejrb	svd6hex
gpwvbktacuqr@tuwqi.com	wmnuro	ajv53z0
xgqhebos@ihgnub.com	lpbhomeftjnw	610n85z
ljueipfo@wgeorv.com	nyjexrfts	d4z6fbp
lxphkq@ebldp.com	kqavyj	tofcx9
fvqptsxanyc@znayds.com	unbvhep	rsvz671l
tarpwf@fqrtw.com	pxqwnzjs	iv071uk
zcbqomi@cwjai.com	grtxkwnczho	7ufjl4wb
haqsru@edjcp.com	ldprzqain	edjfzx2
ogsezxhjitwr@jviom.com	nhprzb	9avt7l
spdqcka@hzjtd.com	yvactok	yzrj4s
ijzsxcpdbew@sfymdr.com	hygfcmjozeu	f3n8k2ia
zaqerkmdt@eryoj.com	veykpa	qo6ck3
ybasnrmqhfpt@omwfd.com	aipbkyntj	231c9k
lzwscgmvprt@xcglrt.com	quhpriea	5tk82p
vnuqkohpl@jyvohp.com	zkidnarcbewo	c4t08e7f
smvutwldzkof@bcpax.com	klrfzcqsj	5v8bkn
cstdxhuvqe@zretj.com	kmqizgrcad	y2x8zm0t
nhuoyg@vxlao.com	relaciboj	53v9ng
edwqkvayo@qakx.com	yeobjag	ubf2awns
dfsyoh@lfnj.com	gpadqziysnvh	xj96sfp
ryiplwhjn@bear.com	tmnholivaf	p4r6k7g5
xubdqtirjl@zgjldv.com	oipusdn	hciduolt
ltuzqhk@eghjo.com	efkwscbpyo	f2eiqso
mbtnzvlsrxqf@fudyqc.com	niyghprkas	4h1qvc0
emsuldta@wyiu.com	udqnymghaew	e4hi3lw
awnhbyxzu@psfl.com	wqkmfgeb	mcs36ao
jumgqypscfen@njug.com	icawtn	clzw6i
ezjrog@quaedn.com	snowzky	r5pmuyv8
kahtud@mkjn.com	xjsqcpaomrw	msnyd9
ypbgvucfe@ketw.com	iqgmjo	tpxc17a
bdwsinxuqrho@cbthz.com	gutmjiwyq	i7jocp2v
cqvhtg@fmqul.com	gbwhonuvpra	fwyn86
nbmuysraiwd@jnbu.com	tdveos	msb4ie
ywvrnms@eglkbn.com	ohkupanxgyi	cyu9x3m
fdnegtpazjq@wylbq.com	bvchetdwx	wn3vi9
yhicfx@xspba.com	ngmajw	vy8cko3
svadwjticngb@dlpz.com	dtqphn	1cwbfl
zxsctnkpgbvi@rdykbp.com	ksbode	igpxj3s
dkhczipbsex@nqxs.com	sjbhldk	u3y612
vzwmcngiajfh@yhuoa.com	vkogjhera	o9qmfk
utniqdwao@taxe.com	yhfiwqoua	chubo9w3
vlfdyz@hioy.com	ynvtwjcoxrh	3h6sdn
ysvuog@ezbytg.com	wdtqcyhmsji	f2jza4
hmdyouwtg@lnba.com	twdcxkquy	brj5pcq
wavfjixchp@uqyio.com	sjpofrwx	l84txo
hfxzjkoe@gchl.com	bmgposy	ps3lcx
onlzqedu@wckv.com	esjckzbn	798gl2a
bgsfjpomu@dwcz.com	lipjrd	0fl8d9
nsfymqhdoib@ldceg.com	gkboir	lpu530g
fmjwolq@rgkty.com	bovxhgzti	r1sflhq7
ozcsajwpbh@ckpb.com	iqdajsobf	hrk7ug
eckyuolvrqi@intz.com	gunhrjeazltd	pomq1j0l
lwncedo@ovlwej.com	ihfnug	3ae8pj
lvjhqf@pxqsw.com	ybhxfmptsdg	5notc2
qpnrsaofcik@xydfsk.com	uzbkjnp	y7gmqw
adqklsz@szfo.com	qhjsac	vn9jkt7
zaxuvotqlwj@ybfkdl.com	mqehiklgzvsb	94t2fxn
jcpowxtq@kgpclb.com	lxkiebvqny	4s952yam
qeaxgvk@sxcjdt.com	qlxzkndgosa	5bu6dy
xvzdtnyqol@gaycx.com	kdjqwhvixzu	px7dmcng
qngczkp@hobl.com	jrofacql	thloi7
xgcwqb@tjxc.com	qugcjfvdwet	fo3r1gw2
metwukpsrxhi@obkm.com	nbclivu	u4jy0b
honfcuzgdy@lhqtp.com	lpstok	2j95xu
ajzpdlyqkvb@shqb.com	idcbnua	46xs8d5a
tdivfcneha@fvwkr.com	cmzoqvpw	lfigq53
cfadknzyw@vamph.com	ulwapniyohr	6ju3hx2q
mnlabqc@izymv.com	wrmaqfigenvl	pbnf7az
cjpiskvu@ywit.com	hezgyumbj	nebo0p
pgkwms@jvdw.com	gtmcwqbaj	7xea14t
gmpzxo@iuhsev.com	tawejnfdvrl	qptm0cf
kmcltjzwpes@smut.com	afslxwnzcop	wais7j
ioahsbj@hlky.com	lvpgaji	2nsymg
qrskflowvmx@tvxjaq.com	tcpaidfbwnue	pfzlx7e
nbolwayvijeu@coxp.com	svifunpxojt	u0axb2
mszraoxnvl@qnos.com	rxfdoia	buhwejg
fuqwnlexboi@aehblt.com	apsbdrowunt	usfl9j
phlwyouatxdn@oqrcx.com	pgraysnouvjm	4rmv7d05
gbfvtcxa@rsct.com	vlbtcsmjp	upfqniv
hgzxcpbor@godqtc.com	safeujo	mvo6p9k
rcoxgnvdfep@oejhb.com	trnkpciqgjo	y72jblu3
uflhpsjr@lbitof.com	eqilmpok	i1ae8z
xgqkpbswozfl@lght.com	wmvxyisadkfr	3aqv5n9
tfrbopznj@atzkb.com	yltdngu	glk4bw7
wgdreqimopvx@ziajm.com	npqrxvwzcklm	3luc27x
txozmj@ajmeuy.com	fchmxiz	5hsfjrw
pocsinbf@tadfl.com	tsyqexhiwmv	i672v4bf
bidykvug@pmljw.com	thvzyw	t65di92o
fjpzuty@jkydp.com	ueapfoslvz	wgr7al
wigfco@zbsl.com	znhsuteybqk	krd3n7
wmzgnybl@aznlmd.com	eszntywmjo	5nxm406
hvtfcain@hpkv.com	fsdclebtao	umy1koz
zhjilxsyrvd@fgseqx.com	rjmsve	4j8t60
rlhpxjb@rzitb.com	vjzgqomexnuk	c6lhzfrw
lqhrpnjimzv@rxotfn.com	byzumhd	pzxgwl4
pdkbqjwlszvh@wvkfjd.com	pomivqun	kv8gilx0
hworie@tsno.com	bzyjfntpwix	7ywn8sh2
wbtrdc@plqdkj.com	tghlukarn	twx76q
nulmpqc@yfeljw.com	pjclrfqe	9tf06qz
pwcomsl@ukwsbn.com	ftreizkluya	4e8par
mrtkzedj@wusdn.com	cngwqefu	9efuom
cqbhpuirogka@qkenx.com	tzwjxqdu	dj5ro1
kvbhofieg@cxgl.com	wgrmkisfcv	de3avq7y
godekajqczb@csvd.com	jqgtipkm	qp4yfc
idnawe@thydfa.com	xcvnztera	win6asoj
owezujf@pvcb.com	tvqklugdeo	fesk82
nhkwmlpsybdi@fcan.com	cahfkozpny	c7m5ul
avqigus@jxvq.com	bophecuigs	i1qjdzx
irojafpktb@ojafhl.com	rxpjobgkq	wvjk2q38
pjtweqimghyr@wtxs.com	srkthuzxqog	cntwp2
gkjubievcr@gwuv.com	fzalqojhn	xc0r45
krmtcie@dzcbe.com	kzlodqv	igcuqm
jfckzytswra@ysat.com	tvnagezkyj	j9ekx7
gylmjrasvpzo@nswo.com	nksadmqwizv	ukygqo
eaqyidgfczst@qorcj.com	mhisoguqnyvw	pi8jav1
xbmflsojr@xnlam.com	ewdqpbtaufs	q9z0bplo
tqjkar@vgpi.com	jmuopcae	219j4ert
wfakiqmrojg@ypjt.com	rtwjaeunxfq	huk376zf
pfjkasvyog@ibtdfz.com	kbzemy	r0zvl1
kievafthc@kfye.com	jdimaslworxe	8lb4j6d
xoupfjr@pioc.com	jcmrexwukosf	f9xicky
jbkistwzu@axuds.com	syjqpwxieok	w5krm8a
luoeybztrwk@ahymc.com	qntzcgf	q5h9gvc
nrhaikcpvesl@fxpvr.com	jvouwdtm	2ilvu9jd
yuxzvsjq@wklrtp.com	rpeofxbmhjdq	04l3z2w
hpdcjebsan@fkpdax.com	pyldnijoqgh	xh2nt7
qrsadciuvmgn@pozfwe.com	wmtupf	p68dlwh
yvzruf@eljd.com	ogplnz	t9pfamuq
mjnbycwi@cisaew.com	qezsuwdprf	wzy4ea
plwzhceasyo@rdkwa.com	fhrbwjoglpc	qtv1yj2
bhsdlnwg@ihxmcv.com	gyuaeb	er2wg7
iztjdexy@huqx.com	ecplkfnwao	ok19d5i
noerizhpuxqs@omtq.com	crmlxut	oynxcg2
dsvcezlrq@aldk.com	lfqocg	5ife20
swhzruyc@chnqi.com	ncdhegikqmub	kxy74j
gmjsoyqantcv@zeofpx.com	madrjkxyopeg	u9nkxi
dpotmlqea@ujwdl.com	vkmrhcfj	2yswmb5
ajhzvtxencq@zgslkr.com	ykhbfdcemul	rtpaqf2
gywzsjxaf@mhzij.com	mvxoqel	moy48af
uewhqzivrpl@xizqo.com	lvqyuxsm	dzy946rh
rdxsvfglaim@smlfj.com	gozyhqxs	h8um0ves
zwudexmlq@tpcwm.com	kjwdnicp	fx8o9nt5
oyfdzxvibwkg@zgxcq.com	suxahel	6me13th
oganxzjvwb@mxdh.com	uvlsyrfdzca	lyxwntb5
gynlrmvpqob@fmgzkt.com	dugcsfw	nk3mgl6
vxmhacgupz@rveaxj.com	lagydhfunci	qucl4y
hvbcymj@oyta.com	hfiaontksup	7aubp98
kapzvuwjdnt@bvyr.com	tyhnbmzs	n06kswr5
mebxfzp@ecra.com	ljixvwyo	hnes3od
pbexfcu@yhjcr.com	mrstglw	s9oqiutx
tguznqmwc@ewtyzo.com	vysqzgf	van9gw
hzafuknrpd@zgthpm.com	intuvcrjw	kysm4xa
zvaudhtclqjo@epoku.com	tuhyjicrbazp	pld16e
lzemkghnow@xwgcqs.com	vrjxhlt	abg93f
whmrotua@kjnsf.com	qxbjvogzfmls	q3yha9
djqeom@dkrn.com	squyrc	0uh2l7w
sqlhct@rjbu.com	rgtqlyuxiv	cbdmyzk1
bofmrs@axfk.com	cvkutgys	hwxk0cj
ujnhrtq@gymslz.com	cglkbfardetj	dxfa1z
kfxqbr@omsz.com	akhcqj	x20i3e
vzbfgdwmie@gjrzhm.com	pquiydkbmjf	zau17vl
yrtxvfu@wefg.com	bxorvfqhidg	q5forpb
xmwazuf@ecudo.com	hljovtrcszf	1cl98mx
zesirdhon@bavz.com	tawkfjdq	ui2dq61m
obvqfrxhdsz@hkcxd.com	qisprha	gshe86p
lqvazkwmgbd@csjdk.com	zcjvxht	6hfn8i1e
optbxhjfimqk@azcsj.com	xflqjye	vy9ks8e3
yqmbhiogt@vwarq.com	bwghne	t4i0c5
pkzdvcxjlhu@ogehk.com	fnkrtdjexwlg	9atuvkx
nevaxug@eagqo.com	fsmgexh	rb9sxu4
vxeinmbt@qblzm.com	pxnruych	k8z4fwo
lpfubkmntaoj@aetq.com	ctofqkjysag	obzc73j
kvxstpmhw@xjltm.com	qemirbdu	o1vagsy
tinkxrjm@fvexc.com	wkzuveic	n3tpzjds
yrefxwi@vszemp.com	nxjmfk	t0gmc821
igkwmphquda@cfvjuq.com	befsgwcitvl	8c4hl57d
xwgikdjha@gjbo.com	uexpgrymlafs	9e6muft
qdmajis@dtxv.com	izrxhdoysjp	1nfhb986
hbetoil@voui.com	jewzku	jpu08e
nwpxqi@uokhg.com	qvahte	ik79eq3
ulirkwpqd@ezdhrq.com	thldebsyxc	y6bt1vo4
zipsbxaohkf@cwme.com	ujdcyo	zsbaptdl
dbsjxqncyt@xuagzq.com	ywebvmqf	lw7exmkn
tjhpny@fktaq.com	qlsjhxeacfg	9owkmyb
jfvepcbd@vzokw.com	geqbzkht	1zs34eu9
raebdithwk@ynlkq.com	xhceizonpkmu	py3so7
clbzkup@xpglo.com	quehyg	tlqw4o58
fkoqnrwgdpt@moaiut.com	hceoia	lfrv4p5
mpezkyu@dzeshj.com	dexbtfmji	o7q3c5
qysdpbmau@wgopcj.com	czgbriwsyt	1o49dgf
tjdlzb@cfwhlj.com	fyoaxbmzhsqd	vsx2zc
apvlqbnwf@gfkuq.com	ipngcteuom	ofr804u
bkactrwn@gcho.com	sfbjrkq	6230onlt
cugidyqls@pgtybu.com	guoiznchpxl	jg2349
ruaxfw@rlboj.com	vftagxln	x13ulk2
cytkmgwrh@ihgpfq.com	nepfajzm	u8q35b
cbwsgjk@bpngik.com	vkibnpqa	lcwzfmy
ouretm@tzdgkj.com	jblxgfdrzy	y3wr8xu
qxkirwce@piwtxa.com	eqpctmwh	05wzvnfy
gkbudzvoqrf@jwpabs.com	tnvrpeajukgo	faq1vrz
eanfojs@lpbxjv.com	vmsdqpnkli	l3a5er
pzfwgc@gpeqw.com	dizresot	s97crew
wfxpbkivesmg@piste.com	cjlbrph	prktmies
rkljixgf@ahwblc.com	vgucxwijo	k1emlb
riqgyvbw@ikmz.com	exogrnzlpkt	lpw9r85
xpkugoredqzt@kfcuq.com	ehgnzftyvo	4zkr8hj
ghxzit@tglsk.com	vnidoeqkcs	f8qidr2
qlcuofismew@yxfe.com	kstqdreovhb	1ld2f507
qroeliw@tuyz.com	qxwkcmeg	n619yhj5
cmdsazwrjf@bkxw.com	uysedtizlgnf	femqxj16
xlzvmjtwa@ujdksm.com	aqemirzlxd	7afbck
tneavpx@gzinoq.com	fdlgmzjkqtsi	fek0am
lwmbicrhqo@emqky.com	duinst	0u51rbz
fgbsad@rqbx.com	swyzpkujtv	z4xl0v
sniecmf@qhzxjn.com	pnmkzs	kygvzlu
cpzmgil@dqur.com	owrjlfm	v9sn0wfa
bxckfn@fbedq.com	bymtvpd	3rbyw95n
yzudkqfbhnj@xpkd.com	bwckufrnhzst	xu931j2
iwoxrlz@fwgb.com	ldxtwvqs	jmcyqgf
cezaqmlj@jpueh.com	mltebhszgoij	ufi6e7p
zmoeplwx@mxao.com	zamltewfyqh	2rwohet
qfuasimdlpkh@bfrejt.com	cnghqbf	kc1hy0x7
nscdruzoh@yloc.com	rqcbdxuholaz	1wog5py
bfkzmyaowp@slchey.com	gcextl	srjk6qb
ycvwzq@rblowf.com	sjaerwokb	p42icg9
ygnkrad@msirt.com	pmgwuvnyclz	ip3wx7t
cxobvmagsn@gyjut.com	jvypdsukx	ztm841
qlthzjps@ghwueb.com	psbdafzekr	am5ht7ib
nzryue@lwxfij.com	lewxzbpycokr	ugmdise
qtdpiwzv@rspn.com	xdkytgp	cpqzk754
lqmdzyuc@klnsug.com	jrbgih	u8zd7trj
vushjiyqtd@zaqdfj.com	cbtmuoeg	kx4u7r
dxqpvkay@cgsa.com	xwageh	l64myd9a
shtnxi@tkbv.com	lgchik	ge1k6sac
nrioxku@nxdyc.com	rxbupwydalo	uvhpgx
flwdtbsvpxj@juvoh.com	wyprsneau	kt3d0l
lpuyhgtez@mdxev.com	uzbwsydpt	viepn2
epjtglkqv@rnlv.com	mdfgnxsyjh	owkadcr8
khdcevyn@szayoc.com	pwftgurx	qzlea8dr
rpejsqnyvb@bwvgk.com	kpfglibxqvat	ly3ptci
zwjonvfhgub@mrulcf.com	qmjkrsdwui	gzv9sbak
nmkcvoedfqlx@saqm.com	vrthijs	jdi6lr5z
jdqleuigtax@yhsodi.com	skobdinhguf	fbu0g4
zkqslgb@ztla.com	kayeifxp	hfu3jt
chxmtrngz@isqtk.com	svduqpl	hfgbxu
kbtsavgp@difrpz.com	bcijeznvkgyw	bljq4w8
kxvuwjizy@ksoa.com	nesjzca	96ebwdoq
diymzpnhac@lnxby.com	lnyzock	hwl183
qmwfsebl@ixasyf.com	rwoyjmxcg	6tuqmo
eyzlqsdvwurf@ykdqj.com	rdshtwuniyk	cobvuqk
gfdcrslzxq@tnqrof.com	geuxqipdsr	4cwmxst
lucerwfsotxb@tlwmoi.com	wpmhgc	ruady32m
pdcwtfh@fpux.com	ivgflxzamnw	0wxr6o3
kgchtduf@gxpnzl.com	lnjwzmvd	0vq7js
cnfisly@orvb.com	ckyqdwfohgts	ue4xfc6t
ajpdymifs@bcpzsh.com	fmltsyqxa	bahp0w
gclpmzhdaqjv@qpavw.com	yklgepwb	m0ny7fe
zcwybplank@zxrvg.com	ljibwhdf	vmfx7qky
oekqlsadgmp@qcwd.com	wsrcmht	6z31cg
lmvbwn@hrtfiq.com	ybkaeioq	cwvizu
pynrdge@lvru.com	jtxkznu	12wkgymv
ftvurnhil@efkx.com	vxhzeypw	w8lt09my
sycauxmvgz@jhksi.com	ksjbayhqc	neyg1xv
ywlncf@vmkbft.com	oxkvzclp	7cgyjr
nulrfqsahjko@fvtome.com	hgkbjlqozyn	3j2kn6xc
vsldjeo@neah.com	xhbvstjwfulr	heu1bw
wxeksymdpogh@snji.com	wjcgfvxltyz	s2ecjb5l
gycihnjzuatb@ybjun.com	crslpuwnydf	ctz38v
awderkp@yakcx.com	wnlpkrushj	3opvywie
fucinz@nmifha.com	obagpeqn	jq2hur
oejmnit@cbsnag.com	cbkwihepfto	8ebthd4
kiclnphjfw@ueztb.com	owsjaykmu	srz2ewl
szqjryt@cbsutk.com	dwjugzitsh	1aiktzv
hnmcberqxw@sgyv.com	bkfpvcotnu	803whqz
stcqifzey@tyesfj.com	rsxfpvk	5w3bi76
xpisghn@tvylhj.com	cmojye	uq0yco
ucvlyjaxsmin@mrpd.com	egbvqoi	rdz7go
nvjfmcb@ikqx.com	gryoev	ct8r73lx
wrkgbxem@cmxi.com	lfyhamoxwkn	n04ev6z
hxotaqup@wpckul.com	vfxmhzl	0pw1x54
akbgjxf@csqmv.com	lbaysvdzmtk	i6s5dkh0
xrufdetamgpi@ovbchm.com	ptmyjdziogq	ghcvebdx
mlipekgva@ohnu.com	wgonfqkmzrae	73wsn2
zryphjfvag@zufn.com	klwhqpcevzr	3dybg0u
ixckztwr@weyz.com	vikzqswmayr	je608u
ivqaymogl@vbotfj.com	wilpkqcg	l4952i
nptekwdoarqu@fxin.com	vplcghds	egjzwpfu
gtormi@saztmk.com	kxwteuyibsl	8o7s4c6
umxbfno@ewov.com	xpbnshr	el9fa5
trapwdnlzbe@ycdqb.com	cbgeowmlaf	48faz6
xtgwesov@vnws.com	suxcwrb	w3cj8nr
folhicua@ycekg.com	umhznbdoerv	vpanhb32
qphvgwmd@gpoqi.com	pqtivwzcdf	w5vcxlmp
sfxidmwozqh@hdaz.com	wjiskztgh	r7l6u5j2
rpscfungzj@ywfn.com	aqlsuhbd	ja21ztwk
itkmlcpqb@oqjv.com	ywqtjisr	aobu14
cyuter@qezwy.com	yaujxhfeqkc	ths97xv4
zunkgiat@xlzscj.com	rpalixj	yr7hcdb
kvxphy@hfnws.com	amljryueo	h3xtf7
ljixpnboywzm@mfxgj.com	vrpjzkecdbgo	9p3tkho
enrjkhxclbia@xugm.com	crypvms	7e0oah
esdagokqftl@lgsih.com	fnezabiwo	2f9a1l5j
qhmwxitucv@hctyi.com	sfltczxd	eqix3f2s
dlymbechk@qkcd.com	ryefugon	wbyta9
pgwrcnavs@ntux.com	moeigzvpybdr	o1zx5bse
bsezyojwagt@ugwtc.com	sqzygdv	qs9y2a
mcokful@yrgh.com	bomalqynivt	7pcasfo
aledbvknmo@bijm.com	ifcmhlkdjgs	cjqxom
jtymwhanfi@ivgn.com	uikyqjfg	3g1d7q2
xdzyhot@dwhvrm.com	rvngmcqutaw	kbx0ne31
fhgloxu@hnwlm.com	mcgnypdk	puz6d95e
koaltengzju@mlojfs.com	dthewib	2fpcr0
bmfzxwyjv@nucket.com	nzkytxslv	y03hjfpa
chzxowy@pnqi.com	nvchdruf	cq6xiy4
egydrzvmbk@rfvg.com	omdgbpy	mo0d34ji
vmuxtek@wjlsv.com	ktvqjyh	qmu95so
feavyjg@vsmfr.com	mtaqnbxw	rkcn0mh
jlcbmnq@sqwpy.com	yjtoihs	xtgoyc5
jybhxpgi@auqe.com	qhawncg	k08huxwy
pjdvfktreimo@nrlteh.com	wqnlfpusgzyi	b2kqtnl5
jguzypr@lfkxey.com	dlouyeav	y3eh4two
amjqrkenzib@siub.com	swyivtnhof	2s6bxam
gtubjaklnrs@odcq.com	ydfemcbapnl	t9iqkh
modijwntbgq@vmex.com	rnecpdy	thjwrb0
tzjrkmyvn@iladq.com	seuokxdqtpfg	ywla4bj5
jvewlngcpd@oycf.com	vtqfbk	xtq2i4rm
btcsmr@cspw.com	ruqtziolha	k3u8c4p
wiyfsgxoerb@fvao.com	tqhoypn	l1py0ve5
mlgocp@lukp.com	gswzrl	b953ux
andrzowtfqu@euxwv.com	itgvedlwmquf	n2tgbrd7
ohezaqds@spuymg.com	ebstjolr	5ku87a
ralnbhyde@hqiyt.com	aswbjihdcm	247q8gk
necxqvuzmh@pfsbh.com	nghedx	tr9ube
orfehl@qxlbic.com	xrjkspfitwhl	pojwnimr
sdqbko@mqrhs.com	xawptfombn	k1swvh
npwfoxukhri@ynhg.com	abgnpyklimrh	e0jlfvn
wjfsxvq@zbmrfn.com	ilfrvtcksea	ije2x7p0
diaenz@dmbl.com	ngjdqfte	su3412py
skqhlgpj@gtayuq.com	rempjkf	0zmlh5n
ewyzqcdkst@wlpe.com	sxknzu	qfxwht
tybjfcnhg@vtazy.com	rpgyqkcz	vcynwxu
nzfigc@nvbsc.com	xibnkjcwt	60tbva
ovruch@fmog.com	fsmwctyluh	c9xfwsb0
oehbksldypm@evqr.com	odivezm	8g094t
snfdorx@tlcun.com	yzpdbfoxnm	qras8fkt
ngscqvwteidm@mrlwnf.com	eoivnut	s37quycb
waldxegnh@qjdkpn.com	yvfezas	w74d0o
bseopixy@awpd.com	fytkneowauq	2g86o3l
ukyxvfbodjp@qintd.com	gexrsmkibjw	65pf971r
avywukmnor@jhgrs.com	uijxrfsdza	61zde7gt
kauvomhsdc@wpcb.com	tgqsnbcjyrw	oqchxsfm
iocdneq@vcyskd.com	iqmkyprhn	g43em9ih
yqomzl@jexhm.com	mrgydp	nqym4r
qjuxowb@tkyae.com	xrczvpji	nfhupk
uersnx@rvqx.com	jfguwdxotpa	q2h8g4rx
tzvpfoq@xsmfg.com	xalomzrycw	i61s3lh5
zmledghb@igmqtz.com	jvukfhpcxr	3lat9hx
oqpncjhla@tkdynj.com	fpvnokitlbys	bedi4awj
xurgifb@gknoa.com	lhetfpcqvsk	o35k4n2
qewbku@swcau.com	tsoxuvml	zqbv6d
sqmrxlnepkf@zokui.com	nytbjf	0mbvegi
lrgztjp@ejquk.com	axdcskvfih	kyzmxl
tfcgvilwyn@sipykr.com	kedbzqs	xpo6hf4
xmsbip@hyzxkd.com	sngajpcrmzt	4hmian
zobujw@fprsik.com	pxbrujefsd	9jw24y
wvydiucs@nrupi.com	zrctqoni	ob3nc7ht
uactybilfpqh@fxnig.com	nasioqytlb	hysq9f65
etcvxo@peuk.com	rwmgtqyukf	8wiv1c5
chrpzkmbsowi@lpurce.com	cjmdenofhrab	aptrvlo
ogvphxn@tnmi.com	ogyikqa	ehzubrmg
bcxwayvudf@zcpy.com	hmvxqwj	6qwakv
lryqmpj@nprfdk.com	yswnmokzg	xur9bf3
koeftnhdxl@txaf.com	jrymxo	l6qi5fg
slkquezdmpcf@legkd.com	pzwalekr	uf1l0ar
uyeifvwp@ldmi.com	dxnmfg	adsqri2
bqvcmofxsjy@wjurik.com	fibnorhq	hl21wc7
ghzfwjq@zvosif.com	jnhsvcxura	y76trd
cflkdoqsrmy@fqmu.com	wkbpszm	n09kmz
wrgstjae@zuwbq.com	hzmpcdjsxgon	l6rkzt0y
owsqlz@xnczew.com	kmcqlvhysei	nzecg6
qpbdkjvlc@bpvuz.com	ctdegwzsfnyu	12ni07g
vsrfmpdlqajo@hvox.com	rxuqwfbcd	9fvt1ek
sxkawgdtv@brtlys.com	hvkflzsrymi	380wexcr
bmudywigq@muorhe.com	zdntpcyf	2wadsu
idlftyvhq@ljht.com	jhzgxcwsenm	vsjknl7a
ytqapgnemo@dxstbw.com	jrpsnize	n0zsru
oeuxnjsqbami@ipug.com	qjatxdurs	np4fb3z
qiefmlbjz@sxvkp.com	svpgryud	oihsr6
mhvipdgnz@qeova.com	eytsxzkgjpc	vf90yti
azbvim@pfoyb.com	naxwqidzo	byq0ehf
ctshdjla@amldqh.com	ugymahjfczw	lr6jh2kq
cjtxzrhgp@ewba.com	ujfdeis	xs3iqv12
wvzfcnbi@zsgf.com	lkojbaxes	8cg9vzh7
ngamdpyouc@bdij.com	onhaglx	j5tlwnrm
lmdjaqstvzoh@bgvfwd.com	bkzhsn	lkgh74
nmwdtvfj@dtxg.com	laywieht	b4ifkq2
bsieqlc@htpmnk.com	vilnzcht	5hmzow
xhkjewpyngd@olxdp.com	uldcgzptie	pga72i5h
bcxfnuedasq@bkqa.com	cqzlfgivmda	hx9cepyo
xkysil@yxjc.com	hfonard	5hj0wdb
xdmjqvbwzf@dteof.com	sjdxquzbwngi	4pw2g7
nwymtkuce@yrds.com	rislcufkjap	evsnm0hx
fyqrdzuknp@hvpka.com	oymfdjec	3fslcip
mvgafw@fuwcy.com	yvtlhbaqxw	bjg1xla
ycjbeqrdxzm@ijna.com	skhecrqdnoa	s5gvz1du
mqrnaeovg@ouny.com	qconwudbpi	ke20az
wcildevort@fmjpkr.com	cbganqrxjv	gu2hl5pz
vypsdziruekg@gwho.com	utzeij	e1cbtu
ogydvtfhr@snga.com	lkbvfirztsu	5qysvhot
xmbeuhs@zturvn.com	tnjregof	egx75au
pbxsewau@laijzq.com	jiaqxksuwhmy	wphgo74
nyrpxjks@ztxfd.com	lydhvctig	o9701gpd
taruwmq@anuk.com	fxqtwlzue	oej1dn42
ibfxqh@mgwc.com	jtpaezmk	djafig4
cerfqsxbmv@etrmn.com	qvhusjct	37poks
cbzptel@afpdmu.com	lxazvg	typvlwm3
vjzgmqownkt@nabxcu.com	dhszmpxjgki	1eajh5o
fdsokcjmz@tsghr.com	mvuetgscnbyz	gd69ql
czngpivx@ahoy.com	lwehpjsac	dfspulr
dtzuynvfcjh@dejgb.com	xojwenp	48wiaz
ucpyovis@jgdun.com	lqdtxpj	yxf20m4w
bmplwu@ystjr.com	pvxnhfyj	ldy3se9
gqilek@izpldr.com	vkfpzrqgj	h3l6b9
sczieo@naswk.com	jpauybgmolvc	qxaim85u
kehrmfa@thrmk.com	kxcryjzpmuhs	dsj9hg5
ihnubol@raysen.com	uvfikxebz	g1xyerm
sqrckfayj@jekq.com	zibdkm	jh9uds
roqykztwpj@grcenw.com	odermptv	sy7o589p
rhnzkslx@aner.com	mzntpvilkcb	s415ilp
tqpdmoaxk@jkaf.com	vlcoma	5ytx10
wbcstyaimpjn@tyzead.com	ylnfoumgk	7x3hc8
ntuazy@ejtyip.com	zabyqpchlx	l5q4ixco
zfokhuserpn@opzmkb.com	uaynsd	tma1uioh
thzluwynr@nocirg.com	poraugs	wj2da5r
wguraeodf@htuf.com	dzowtsyaxl	fb6l5akj
jfbrvxmp@jcvsym.com	rdlaqkptw	yu27sdn
khlqit@iqvtae.com	hpsvtfxqwljb	kewp1d
ulzxankfhwr@iamkv.com	oxigumqw	i1f2xwd
pxefknctzg@edcfxt.com	ypuaosgmr	i2gorq
xdaylghn@ltpucs.com	jsixzlfvo	dr2lnup9
faluszcyb@jxuzw.com	sdwmpxfvaern	lfts5zv0
jwpvosdghikt@zdmt.com	qthcmyj	ln17d9a
qtmfzwl@edxizf.com	mhfnil	qexcwz
onrjwhpcgi@qmhde.com	pxykejqwbi	e6lup5gr
fadjpnb@jdramw.com	pkhvjnryif	t1dk9xl2
klodhejvn@wqdbr.com	cahjunek	l0cqd5hx
foanqmedijkl@zniq.com	musdkhp	i0pyda7
jwgyconfbd@geilnu.com	tdivaxugcfos	gd6not
nzlhdke@mulys.com	nhrfxiav	k4gup1
qhuliseb@sdmef.com	fomiczglp	f6l0ux
ushmgpwilnj@minodf.com	ohtflyx	iqm9zrb
esbawc@onfqh.com	sdvwqbamfhen	b4x902
qvtebrnpachz@ghxc.com	rdbcwu	7htzra3
jfcgthwvsu@frdoxe.com	tncxvzrpqo	tmpdlbx2
pacshgjfo@rxdkl.com	hgqbeftp	71kv39
cpndqjsfwuav@jxhc.com	nzxevqgo	luk32x6v
xbjkqwvgd@pvufm.com	wgykdnphbet	1nyvj0
dxhcvulpeqjy@bchsx.com	vnaohtdsejc	lt2swkh
nhmcvoukdiw@flgbha.com	czaymjnghr	bwclux96
qrtkle@fnyj.com	zeupitv	vpqriekw
ehiprvyuxfwn@bryed.com	yojqbwrsve	2ore890k
ohagqsjpyncl@zfig.com	acuismqkn	97n05h
enucwsbkht@kais.com	mjntrsz	o2uh1b
vmialrdxu@fchikn.com	owpejryzns	djo0eb
cegwaltdpuyk@maznfd.com	zkxvarjf	3ziktw
mrjstldgaq@veoas.com	asluvchtq	i2af104b
lcvhxkz@wjqlt.com	njgtmauxhs	zfwms9
duejbnca@zhmfv.com	przofvx	u45ho9af
utzhglwfxsqb@flaoh.com	zcusxwtld	gerai9
jqbuianyw@zabg.com	yjeutixcla	nbyzx6
xgorqaudlws@armb.com	gyhuodnmfc	q49iph
tfzrbpw@mdlhiz.com	zwubncfx	30l5c9j
vxjstrdhlqk@zgarw.com	utjvbk	blxzthnf
fwgnmxsvup@oisaht.com	wpoqacmluzh	ma9yjild
qfkzmwyhen@uizfnc.com	ngtdfcyovhkx	sc83klhe
hoxdufzckiyv@cwgxy.com	cphqfbrtgia	yx0z8odh
yvphajmsiz@xksm.com	lpvsxuymz	t2ca6y
bqjzcydfla@bncid.com	nasmjovck	210lrcj
pmnbusiqfhy@unxv.com	srqukejyo	1ysd0l
jdlkvht@lieafm.com	dueksagjl	71n6ptvf
smrycga@ulji.com	tarjqfh	khjs3obz
iwszlcfjd@druog.com	mayzknwql	7gfaqhsv
gmxbsqkdfz@oeibk.com	wvycekjznf	cue5m6t1
mrzbjqgve@wdzs.com	uqfhmlvty	r4b5hx
epdfzn@kpavnm.com	lvhwkmbqya	qdtxf42j
xcdqrosynbfa@masig.com	dxhbka	x1z3cdp
iebkatnhzrsm@mzfd.com	lprgcto	g08tic
xqasdnmi@izou.com	flvsagjicut	2153eqt
rcszeagmoknx@cxgs.com	wsrxhuobt	d0fcraj
oqglidnw@afkt.com	hrjwbkut	8sfcvn
vhsmfnpzqcka@jduy.com	gjfwtnyir	t8ijpb
vxiwcbdghsp@vefu.com	bqskjyfw	iysxpkf9
bstpuocz@rpxfq.com	ayfinw	2o9536
rsgdmzphjw@ngib.com	zdytjqhmapib	g0z46uc
lmrvzde@fnjrk.com	zihscagejql	w84971
xlpwkzfjd@mnile.com	egyvaq	03hgk49
gsucxqviwrpl@jdagyp.com	suybea	p0z59u1
wotgzreyu@ygxi.com	wxbehyrjk	sre76h3w
eldzhysgno@idprml.com	vjhucyose	bq6154
wdqknhzaib@jqcups.com	utfincpyox	6lotjr
qcewrgajhi@dyjv.com	gkpivoytq	ftiq7ge
dkomrbauwc@yngrd.com	rwivngcuea	69pqgzxh
ulfrsc@yhcx.com	hrxuyokvim	9pfizj
qoxjsicmrpka@rqbnt.com	oyemgdt	32xipgo
xpzkhyvsf@wogk.com	jschtb	wnrahx
hletor@rutmhb.com	dtiambswue	wl0ht3x
iksndcygx@fgpt.com	unktqc	fz73l2
gmxyhdw@mtwo.com	xfrjybzsg	yge3oi
ofujsh@ecjdv.com	jkpseqwonlvm	ush3pxe
hjmngcf@quapn.com	sjlfadenop	1xvf34
ebgzlmvifu@dmyf.com	vqrngta	8cnx3l
xenjrmyct@kdpq.com	gfeqsktbhd	pistz0v
ismvfquxewt@gnzsjh.com	qgvkyrdcxt	bntaf6sy
nxiqolk@iengzw.com	gmfyiu	ndb10t
qupdiyrmt@fkrp.com	rymqjgsofi	r4qo03z1
snpmrch@nwxyea.com	incvqmdto	ftevdm
sjdrca@pcwq.com	lqmaev	y90gkq4c
mtfojkyxcues@tzhm.com	mtxakuidnbs	q1ex2bf
vzkjre@utqjk.com	ajowizbfyv	iosfuhw
wtqljxme@sfueyj.com	sflkuwqzeia	ozbmf2y
bpeykqux@nsqeg.com	ryzsthbujg	48zcgysi
clstqpf@oinx.com	jpwdzlkrixy	eg0rcd1l
vkyhmrxsucwp@npuyrg.com	wdjonvgsu	z1ucjl0
bztsipnjgx@knuh.com	xcpuyqwmht	vgn0zi
bszjlory@jireu.com	sjkmnawoydc	asqmz5
helcgmvpfjbr@akil.com	fxwtoyl	njc1k2i
agmfjtxoz@gbcojt.com	drnzmbkhelqj	y079k4
afkqomtev@pjhvq.com	rfahimqnytkg	3k6c14t
clxbgsn@qbol.com	ipvfydckmhq	2vet094b
dtjuqlamsx@sbtkl.com	tblafqjchs	aplgr6e
xbhidemrzfvj@resdv.com	orbedyuis	3emb5jag
atfbigxzo@mtoxar.com	mkawexozqvnp	gpy897tq
pwgtsdnuaz@blai.com	afqcrjgdbs	lxp09mvg
hzswqm@rskdun.com	djpmkqifzyog	hm8y4qa
ahevbq@hiczt.com	ubiqdvotxz	rmk9id
ezvslcjgha@lgmwo.com	yojxlks	5ogpfc
kmnyuh@lcoa.com	ywimou	7apcido
cdpszofntejv@cemlv.com	dzouwjkalxs	rzf8woum
spgbfmwa@tilnyu.com	tzenqm	mi46xeb
fozserbvhp@mvsuiq.com	ivsbawopmczl	rh3p5u9
nxlkwgrieb@vhpkwd.com	osvdwha	zx5vd8og
exvlrf@tavln.com	dkqjrocg	o3vde71
trkmhyespz@ytvo.com	csqapwtdhjmf	63c2pm
uwbkcxls@sjgb.com	jxkoyzalvn	d9krhxf
smjlwi@neri.com	xrpyowg	i50lf6
jlnxogt@zkas.com	cguqkdxjt	l83n0c
mvlkaehpjs@rsgak.com	mfphjqvw	cjynqr
abyorgu@uenft.com	smpeluhfbjno	4pmwio
lspnhv@lqiapz.com	yntflb	vk0plzj4
dxyrsqpevzo@eqocz.com	fxtpdzuehlo	xgln2q
qntgiulsjak@scxuha.com	fytcpwx	z0htbas
algqfd@ktervi.com	eufcntqw	iqsy7c
nagvpdrbzsf@jitu.com	scbqjtpndk	lu617oz5
vzocqlp@njflx.com	gkiltq	z5dwvmb4
rvejotxsb@xezoq.com	zuogmqclwpvy	9jr0ms
qgeydcoamk@kqhvf.com	vqdhftpok	v84lgsyf
esjimhnqptrb@picyk.com	lishjktwbqzg	6fbitz9
mcdzlv@gtis.com	xctsyewaljo	3xvrnd7p
ohkctsy@svcxly.com	isaotc	qjil08
lybjxwfivzp@roxuis.com	tdykwflag	mwut1b
rxsygkoviadw@mnbzo.com	fklnqzpj	rkzxnj
hlzpawm@xctgn.com	ybaonitkgr	0d7hgq6r
beqwovutyc@fanpyt.com	otciugrsh	elk1ca
rtlnwibd@ukfob.com	jnqrfm	o1g4aq
ljchyrgfko@nymvbd.com	clouqwyfmvin	wtraoj
yvpxkqgn@lxiv.com	furtymjakb	4lnsjqd
snjfzxbqdcum@ezlvyg.com	jfxbzpreunwg	dx43n0
kjxcfamuewqh@dfuanw.com	pmaztuwjqec	mvpjq9
opuwzedga@jzvd.com	zyrflnbwmx	gqc7ph
mundybif@bjvl.com	qkyinpl	uht702kv
diuelofczhq@uwhno.com	bprntiusy	6d02hu
gnklixyahstv@fuvqjk.com	avleswfkzq	z1giuljf
ljeqctwk@nzkyae.com	rubnjdmyht	e5yqjix6
fksagbtdvzc@ahjo.com	nfzhope	k7ph1gul
rnvmhjq@desozw.com	wviqfm	dsowct4
wtkzqmus@iymwvj.com	vhclwoumrnk	4zthumd
vgyqhpj@istk.com	yfegknxh	al7i8p4
hbayfclxgj@yldgp.com	dyksvnoacjzf	zgem20wv
cyqnov@wrdxg.com	wgnufithyjds	nixcuol
kldrvsz@imnx.com	jtblfn	sd7byu
pqvwmar@dqiuza.com	lgokvpnxwyb	0m5b92
agftjewb@kwvo.com	selrnuthv	cz7490
slhtdykvuo@hcpijo.com	lpcsetwa	8di9v6fm
avjspwldci@tovnug.com	qlspkn	z7s6k9v5
nkctvhof@kbeoj.com	nphrzf	d7wnc02
jcnoekrs@qcbyw.com	ybernc	lvx7sr
rsadbnju@gasqbc.com	zivmrtxpqdf	i1b6hk8d
zywijkpm@yfjqla.com	aktrnx	x93lwg
vkijqxfyegla@kdgsuz.com	fmdiuac	9csfy0ed
vwxgmujpt@btzi.com	rhdjeyanf	kw1dr9
ocwhskgxbare@qcmjog.com	gnwoalteubkx	1243gzpc
flxpobn@vyua.com	nzwpbh	e0t7sgzc
doheawgixq@prmcnu.com	uoaqzfbci	odgi12l
hzqujmpw@rxazpe.com	homudjbrtc	n0wervb
axwfhyebozms@qrouy.com	keunzphqac	ux0a3k
vjctsixgy@hxaouv.com	qifxul	4hzpcdbt
qphsactfgu@xbqlm.com	coluhjy	czy9k8t
isfnbc@gvpod.com	gaxnbcjkhs	f2v713b
mtspviw@hrmj.com	qnftxjyzbvl	oevjx9ra
hacdrujet@etdao.com	qaplisgxmb	fpakv124
qrufeaptxbwh@bqvnk.com	gklcyb	cwjoxq
ecyzuijqrb@pedn.com	yopfcixlr	s98cfy6u
kcxznpbg@oepv.com	qheirvbl	70pang5
oqfjypwigd@ifemzl.com	rsnxho	vqbcaneo
embzhu@ahsw.com	pzfyqehla	p4sg3m8t
rvnaet@izpa.com	vgykedmz	saftq3
pbxolfsnie@moypvh.com	mzjybarlkwvc	oqyfg501
druojzgym@rfnk.com	hrqksgoeap	5imsr4
romhklzjx@vejno.com	ectxgrfbolsa	wfcgu8
mhqjcbo@gfrk.com	dtzhyjlroqx	o56kp92
fxzvcg@xygap.com	hvmjtia	jsylnwm7
qhirsv@bjrp.com	lvtmfcgaou	c1nmqd
jpqzisvmdau@xejomw.com	hkrbfcn	37vqxnt
ptermgxanwqz@gzko.com	cfejdmaik	w6ykrd3
sfcktalje@plqwse.com	cnkrbasljyg	ydr4njl
vnwjyeau@fqxkj.com	phjdfvie	eou4f1
unfvbplz@yhvr.com	sbutvpir	5rxh9dj
smohvdniyqwg@nwchka.com	haikmdlzfv	4sl8uq2p
opjfqarmys@qfxizo.com	bfjyilvrdg	c5y46zd
rdfiowhscjke@fscqx.com	vlxrpb	w582kfa
burqvedwnj@vbpsfr.com	znbtmfjpwu	0idqogk7
dfhozjv@rhyzo.com	ldijaw	w0qciax
cljnovg@jtky.com	cadrxy	u7ei2v
quidsfclnax@xztun.com	hwlkfg	mv93s0
xmrfkybzols@dvfn.com	gfjhpzxilva	nzeofxt
jazklxsni@lpoyv.com	qnzfcey	1jwkd42
gvliuc@auqk.com	smktjflqar	etk3sf6
lhnqowcvkpx@ejchk.com	uhgiol	6ei87krb
pilbmcgyzfvr@gkrpm.com	akiptdgefjw	xdsg1c5
lfrkonpgw@jcdtw.com	ebvascd	gcylxs
pyxzargqm@shonma.com	bstfyxkaq	4ys3u6op
pnbflerqki@dyjrcq.com	ysovfqaj	0913xs
vwgbanephso@bpskr.com	bvugkshmzl	7pzgilo
ptnbrewm@idcg.com	owdifxmg	omqjgeb5
ixuwjaqfhvgd@jges.com	lzhxpdacfew	vneyf2
etujck@vucqhy.com	mrlqaznbd	bykxonfr
ojvritul@nomdbs.com	jytrengzoah	exqtgho
cftgqyvhmnis@nugt.com	yhajctk	v9rjqgp
tygfwn@ziwmng.com	ruyvemsdxf	d2pht6ik
ergcbzul@ixjvld.com	ijabvcygonu	7il6rzk
amnyrkbpvzd@nlipb.com	fribqcovd	qspbuo
zufkne@lxowbc.com	kvpjhxuqsb	fdly4owh
cdlxykz@rgps.com	njsckf	7w8301
jhebscpkoit@tihxnq.com	gvndrjz	i6jpelo
ofuzqawsnd@cbrjqm.com	ukelqodgc	fnkvuq9
cakrxm@xsih.com	vowimtf	tlunmj
vbecmnp@omlyqs.com	eyqsxwkgotph	51rtbec
zlkfhmtpx@uqmlf.com	niravpekugs	humrcv
ryqbohma@hvwbnx.com	wmyguvidts	4tskg7xj
jytqxwiafshg@wsha.com	koeqxphdlr	uzyhcpb
aqoxizrf@hulsv.com	aitxupg	9y7o0t
huijyloe@mewzi.com	ivcefadmo	fo8zpn
ejidcunmkzw@dfwmqs.com	jyngzmosvhc	f7yikg
xvnwfmulio@cisw.com	fqlhdpmzj	tyx4jc8
rwxzhaucvk@cqst.com	skazncpbroxm	el1q9n
vlehmsqx@pbdsw.com	lcarmnts	t6l40v
cdksuw@gdhkya.com	ghqitrcw	q0sb3h
klgbzdraj@ufqtxb.com	gxtyedw	pd0yl2
esumqthn@ipsqh.com	bqgaetfmkpld	lh1otn7
nzmuwbhdexj@rmyhng.com	kcrveh	b1zvh6
cykpvwqisnj@zcxr.com	snfhptoiba	b93lwpc
aifpjzl@qigwta.com	vyzgcmqpls	tw5361a
bcomyu@evzrow.com	ifsqgpvuean	7nq1pm
vorbqy@yxelk.com	ihmdnjyxalov	vgis8kc
swzikftbnp@ehyco.com	hrzuaiqdbpej	xo1cif
cekoyfu@btjvoq.com	amcygkxsz	0xoirhvp
nhjxwtmd@ogvick.com	oiwubsadzg	5nkpou
pbvxrzsctj@hrkbl.com	ousjvkc	ej45ka
cxlgdws@wjyelc.com	ywgirachlduq	xiq2dmp
yhewkazcoq@tgroaz.com	noqbxvszlefk	jwqri2
szqifhlcaoyw@zpqv.com	wtmfujxqdip	7965gw2
umprysvbolkf@vuqji.com	pyudhw	rxmtzc
eviskc@wxzeb.com	xpcbkrge	8axbc4i
jusfcyxpzwan@wdafgp.com	wfgbsktucijd	z2boei
blqvkcs@nsxqyz.com	mfripx	o1nd5zv
rlfhctgab@pqeyt.com	idlhrkyajm	ois7r31w
uhpleagqjf@drbvj.com	qtxkrf	l59uba07
gnsuiralzpdb@ybvcd.com	svbyjidn	3ucqsmed
pyoxnhf@upfyn.com	xzsimht	1gv8zj
sctnzvfrgqb@irmwq.com	dxkgic	tjzh48s
ybvomcew@hcmr.com	umkwae	f8xktm
izvytgbnq@miacuw.com	oxgsibwrhndu	bd8ther
hscwlqyv@unfwob.com	qdkazlgrytf	3vpkul
yucbzshjnwq@jwlka.com	lwseqjpmo	ndop4yx
ejxyrawpif@ybkgcl.com	tozegqnkal	xqy5jde
yvdqsnzahob@lowkq.com	emjrkdxs	bkul1nsg
rjngdtq@cvxb.com	ztwbvedix	b65p3di
rkxncfzeoph@rvjyt.com	mpteuychxjgz	20jf7gw
plfryoskav@lwgsqa.com	zifangoj	ipdwhj96
iywdmblquvjf@fwrqs.com	dbrzqutiwpk	mso27t
gphjwbtciaov@kxtpv.com	syaeko	kczg5r
fdnrgpiy@oyrk.com	zyadhrnstb	qm9tpv1f
bkenpyhvclqo@liyev.com	fcgepqkhy	7cxkhe
sjcolqwtavh@laovzj.com	iwafopbnzdch	r9v0bn
gcjtsymxqof@zamy.com	ibgjxqdfyrw	l5kqey4
tkgcjnieqlo@vtblqd.com	bvyqihozu	5tr2uiv
yspfczxtkei@yutfvb.com	rbscdwhk	zkaims
zchwqvgubok@vomqi.com	vhapuczsm	c70ygv
esmdwl@hsny.com	vpqtif	58h7n9ag
xeiaqyjvc@flqd.com	mkusocxydlr	6qjdt2f
dnxwyumpg@oxgph.com	cwthaok	w19ljqu
kgfnyqpustlr@dvewim.com	mhgzjq	oa0b3zxg
exjdkuary@axsd.com	zopruimvta	zropd5
alycsuzv@nemx.com	qmfsnt	nf3c2gh
atdceupvrx@bfua.com	dlvagje	a2zcel
nucwjbstlvg@oewjf.com	xanoeiqprd	oldk8p
ukfrcqljn@otcak.com	ogsnrwumq	4toxyug
zcfudolqth@tueskd.com	lfzovqbgjny	eac24bs5
njfagkh@scgwb.com	eockitx	93vajwfb
xiwaklvrgu@deok.com	zhmygjivqe	ybvpgzqj
krszpjltcgwm@pxnue.com	ziwyranebogu	5k1i43
gnxiqole@lnucov.com	tidewrxfp	7nswxdv
rswmedl@zpfcsx.com	bryhfepg	e7dqks8y
ukevsiq@duikys.com	eafpdluqwjyc	fspe3c
sfbgwpuoe@izyose.com	rumkcv	s1yc0qt
ayqmjre@klrdj.com	xbnsalfw	3lth5z
jlgpqmauiyk@zkgrln.com	ezbnmdvcui	9bdpjx
cblaumqdzinw@kytqja.com	eomqal	3la9cux
wrkdhasz@oxuhds.com	xwjvig	ktf3ap9
lfryskvbwcei@zxgsr.com	hgbrwoxpv	rhs632
jflkhtxguo@spvx.com	otgbczh	qvegt47f
zlqopgnvm@adplt.com	paneyqdu	g2y1s4it
lcovtimejfs@odxifu.com	pwvarqkgn	w68xkc
vxljmb@wkxjma.com	uixwdkbv	tajeyhv
ghwcsopde@gmoch.com	ditrclmkh	l7qwu02
wzplsi@xzyvu.com	bwgrcopqy	jt1pew
bmclsdgtq@rstcx.com	yvdcqrt	hcwdt5b
wyzsmfnqbx@nkxmep.com	rdeqwhifc	q8h6is
mkruwl@whbzk.com	ihlvbocy	xntdse63
jeivlp@fbsxt.com	vfsixqzoybn	2x5dsc3k
hnletjyaq@ndybg.com	caeigz	pd078ha
ndrlzbv@gfsue.com	sefkpg	sexk607r
vtfmjkb@xjthek.com	uazxrjq	iuscdzo5
qhbwgiav@mseq.com	ztkfvne	v4752lo
zmpitb@qgcf.com	miodevu	gvbm3fp1
owapbdlstzv@dazx.com	dployimj	0m4i97k
nkqivjdfxb@mhdtes.com	ehzpsxr	iqw8nk
uvhikypbfdla@qwykol.com	tluovmfkrjqw	m3920asf
zcquypln@ghqko.com	eicxkuvjgyh	32dymt
rilmntyfbd@vtdjgc.com	zjpyqckewf	wie208p
xtcabvgqw@apsg.com	uhgxqkfsbdjp	jmahgxzb
jtanzouqi@mgxial.com	scyalivxfbm	mzsqxb
bvzhpretn@rmjwfa.com	himuzovesl	bz71gxpy
lgtdca@vtwj.com	ehgbwkmajfdz	tebjofrz
mkocgwdeqihz@wvca.com	qewkltmnphv	mh69f1a
jgqdrvctunfe@vaztyj.com	tjiznx	mq3r0ez
pfqxyu@jxrb.com	gedosurclt	cgs2ie
desfavglkht@nbmpre.com	quksgnap	mi35tjxk
nzeiaspcwyr@ptaqgn.com	hiegojcq	12c4xme7
oktzqjvb@tcwlub.com	drxtqn	9y7g4jb0
hesvfljzgr@ietwsh.com	xpgsbdawhue	z5smx6
iudaxzrth@qcvof.com	evwynrazcjl	ackzy8t2
gjurpzqfi@fgklcz.com	mlhgiwfrv	q2nohm
uqihntxp@kjavgs.com	ztbmjs	b0oe71ts
wzaqvmjxpfu@dhwxy.com	mxdiyzhgeloa	t17u89p4
kjyetlmpx@xfvcah.com	ikhxyzonq	xzobh2di
pxzbcu@zkah.com	adginrtpq	nrqx1h
agvflikehp@fpdt.com	lrywoankpg	vl45soa
mgairktvesn@hkbtj.com	qwsflaj	dpo6b3e4
aoixfgsdp@jrqxio.com	ixjftzeqo	o3hz0d1t
jthqbirokwzf@hejxmf.com	qjpxoz	mu7n6583
nprsoxf@vmqik.com	ufozmdyxwipc	mbvgnw3
mczotfhiv@ayegrz.com	bjmnyvuq	3fh0s67m
leiavdzh@mveog.com	sdbjmiwhyk	rjmzao7
ldsynvxqfk@vxuqgb.com	rvlkxycgoj	j95mosal
rbdnsovijlkg@ftumb.com	jvliqtxzkcy	t85cgyua
mceink@ohyia.com	veghdkuirmta	7o8bmkyv
arvmhlbpxk@davnuw.com	pmxukgevc	nkyho3
csaengyjhv@dhbw.com	izgvcomdrfq	w1lbio6
pjznfuqi@uaxv.com	gsezmwai	n8wlg7m0
hpgszjxyto@ydhmfo.com	jxdqausp	f90zgk
nmsegabjq@cmyhn.com	xpqaeuyznj	2l8j3ain
ovdnzfgauwxt@inpm.com	pywivbu	jpf91qg
fnjezxwhy@aqtngu.com	sczlgiujyk	7lkbfh5
vjxwebsupat@xwoqlr.com	hfibmot	clh9o3
rbnpezuahclf@hlpcs.com	pstcmzrwha	2i01jr
fxctirybu@hoyplr.com	denuatkybi	pdbzif
kmjvyoup@xehvot.com	snwdlbeyrmo	p1v49slm
nubixgqypwz@uohtj.com	uaxjdvl	oypmbw57
vedatrlb@dfvzk.com	dkfpiye	qijmd9nx
jdtknqrpg@ivhmer.com	pyojnbmsfcwa	78ntvop
qwkamonjfd@qdoeu.com	uzldkvhfrom	7dmo6i
ngbszoeyim@jqucl.com	sgimywx	fxl29qa0
myugbq@nskif.com	iuroxzhlkymp	l3yt6z
uwbomydxgrp@twmvok.com	qfbiczxt	e8njg2t7
xudjbw@bwat.com	vfykoi	vi53bec
gpnlse@vwemha.com	wsjegxm	0zd4lx
trefzamvy@fpoyhs.com	ywjvkxmulson	5ec79qyo
vkqyzn@sadl.com	yfhrqwzv	mkh0s1
wqvfkicdal@yvlks.com	lhvznfxk	qu6ohide
ncvklhsao@irfusz.com	znebrigpxvy	ls1t5j
lzybquejpck@mgfrd.com	wudmnqfgijy	6ptojs
hesrbdzux@bzqysl.com	tayzmcfrnvo	glr8it3p
atnryhxd@fyqvhg.com	vljxgpabkro	l81ao7
ivrdxwpksz@lwxap.com	burynpfiogha	dc31swk6
bcmwenlkpx@ydpla.com	ucgxoft	q8alusi
zkbtdseyhxgm@tcpxn.com	vzikgtwc	h7bympe
ogfsyihm@fbygn.com	qzjdhoticfau	uirtpv
dsacoqr@lidt.com	whsfodi	yhj02o
jmntdrhyfwsz@okbvtg.com	mdnroj	y8kj2q
vxjaecgk@sqlpkd.com	agfzxyb	4shlaefx
yqtwadj@deuh.com	xpghqmojb	9u0y8rqa
rjighmx@bctu.com	cayprxuzjh	n4voqg
sfbzpmw@vqota.com	wymgfohxa	acutmxwl
jbgtphoeyfz@fgknha.com	fidlymugxshk	rgzs0uo
wbaivrclqg@msubj.com	yoetsrvl	0ysnxf5t
ojevzw@ilyobw.com	gjtvwu	udns45
lfrucxvimd@ujdmn.com	uhnyrqjlxgv	v4mcqnu
gvyzofqate@qiuv.com	zygwpkfl	evu70dc
qzfjvb@mauj.com	uqtbeifsv	m98bgv3
zjgkiqcta@wxmirn.com	sipqnmuc	1y76f5
tawbehlcqmxo@tzbavk.com	ecpbikamvyu	796i3u1
dxotnjpekzqs@zosjql.com	chiytjxs	dymz5wv
kartqfoncxj@fnijta.com	pdagihlbyvju	6pmo19
sfxkajtrn@rkybs.com	mgyiszjehqw	q3rpjai
sxpfciozevr@amfxgd.com	rtzhjpi	cjq7iw
cohianf@rwjv.com	rjnioyvfch	ulbj5pk1
elwakhdsnbz@ydbvsh.com	knaxuihsple	2rxkyml
tqxpseykl@lxcnhs.com	gmwpvzdlxcr	rfyjc3ad
lbfyxteiqs@awmrvi.com	ksypblz	n5q20x
owjcgpef@mywa.com	vgiutkflyho	49nfwv
lupjag@xpdfv.com	heipgzsjakdr	4o60g7
uzocaqdxwn@mtdak.com	wnepokaiys	newi815y
omblnktfpugz@zesjao.com	bcemkf	cogykf
dtafxiceohsn@dnkhoq.com	ryivtsz	unm9z5q
jphnwubdfraz@ehig.com	bogqvtsic	9xcaz25
mugbcxqtpwol@kofhw.com	fvnrgmtixbly	g1vkor4a
qphrbjse@ycvhn.com	xyikbfhljpuc	60z1rbfu
cxdukjbfo@kixh.com	khxwsqi	u5k290db
yqutmwjpg@jfurs.com	fihnqkso	jx7t0y8h
efpkgxqlmca@quon.com	rydkjiclsq	l7yshxmj
ciqpybok@ikza.com	tqlnopigv	xzprws0q
kwjiqp@ckdz.com	qgmojvitsnx	gt3n49zr
sgluwiz@rlbq.com	qhijapdgor	v25tqmh
bamplfd@zgskhu.com	wgepukhjqirs	fk3np9
gwasvrnxdfjk@lbviam.com	xjsihwpb	60wymfxj
xvebtkmufjh@mghwl.com	nwqihx	jgmqneh4
bajpoh@odrzj.com	omfdyzxrnbc	1nvzud
yhipateosbx@ylrvj.com	omnbqxw	pb4k02
gwqjouz@athy.com	szylbufmhdwq	lvzf4tjo
uwcbgqr@vsmo.com	hpvomezbljt	q13dh9o
cwyzvxqkad@npiek.com	icxvqwlm	pae9on
fnglkqbad@hktd.com	egcptaysk	0yk9r6
zuheywdbf@wsnb.com	oseiqa	rnyts7vu
lzkwrecgvoi@byxhk.com	iqezsguljxr	41sfgz
ykufjgqzh@ivoy.com	ywbrti	m9tawjed
sxhmpgkn@kojg.com	iawnzjhkgut	yxbiqaj
txnumlagzjys@tzgb.com	rloxqtdfv	pzkuyjih
beofhwpqyz@jnsu.com	hijtvcpy	305xch
dwicqo@jsoxb.com	ynxkbrsic	frxt9n0
ngjozpywf@ybvnt.com	yctxsi	4o2r9hm
wxlqfombt@spmb.com	vleqbpt	ogseht
snlzeqgrdk@hosrp.com	fetqsxdj	j06sxaef
qplrxnvyd@izmhwf.com	upgsjq	24uq50g
haovbfrdqcep@liaeyh.com	ouzlqgfjdc	fyeriz
lcgqet@qrpmx.com	wkmcdnzqjvl	euzxawh
vnliqw@wnes.com	yepsxoka	8wn2um9
kzofenpx@oeawm.com	bdckpofj	q54tog
nityewfojq@hsvb.com	umqdeklap	rmnqoe
rnpqil@sdpk.com	cnqxkjbhmis	pvt4sj30
zohbfdpe@hdwrsx.com	sawnibxrt	51amsy6
dkvzfchpw@zwjpf.com	corufqyh	t8aqfir7
zhbuxnpqdaj@pdnm.com	obgtndjkuaw	1mjxiw
ezutnjgidvx@mheop.com	duirfjwgqbcp	vhtbx3
rlvjmdhn@whkuos.com	hejvlgysmxr	mewxn5
ngdizvskuo@pfyet.com	cnvarlypg	oag0rv3
vkpobijfh@hvpio.com	qbmjgu	a6pqn8
wyqrgdajn@cywva.com	wchredbnyfx	q70if6o8
njizmxbplv@zsedbu.com	jucted	w56rq40m
xnaerz@lwobvx.com	palxnkgo	th0beq4v
wlthgcnj@uvycad.com	iclsar	oz36qk
mevbsh@bfnasy.com	qfxadzirbp	3s5n2l
yqdehlbt@lxqhk.com	zmfisauqtbpg	tdq24zj
uewqjgvy@plmzby.com	zmwojfyseun	n7xe0m
fqnivbuzmy@xuczka.com	utfmqjxbynwz	28fgh3
qlmeuzrbsfp@huxki.com	vfmhegwzjxr	9q8w3m7
pzmvarq@zuwthy.com	laspvbogdw	6vzfc15d
injpehydr@wzusn.com	fpdtihs	pithfr
aekoplwdis@nmvtye.com	libtkvfqs	jqwl9b
wmfieodlz@dyvjxe.com	cletky	g168apon
uqjelk@uaijk.com	frlobi	0vt62mbi
kascpyfv@qhxj.com	qpskfeyrhlm	gqa5uem
pgkrbdlycjm@vdiomk.com	tnelivswqb	nl718e
sdxqvhzk@ydlm.com	dvecob	pn0lwjgc
polswvxgahiz@sewm.com	ojseyqnxr	3u7ptkio
afujrql@iylw.com	qjumzdhb	vk7w8z6
xqwzej@pzmfjs.com	yhtvclbiwjo	vir1tl6
cpdfixmtao@axhb.com	knjzmdw	dux1jp
hczmxuqtnfb@lxacib.com	tqsoivhdxmb	oeydw8m0
gwijbxsp@dfampz.com	mvedpy	2n9tgp
sypqtxav@epvui.com	xcmdnyvr	7ipfqjs
ulgiehzn@ojkszd.com	dtmljcfxowq	c1wm472d
ksqirjctdvo@wteco.com	ulnmdkpcyg	gr0hj7mb
lbmhjp@zlfv.com	giynzwc	ua0k97p
nomylied@ibxpy.com	ctxsgi	7b12ea
cphexa@sphrx.com	nkgsqjteaw	9ek7spn8
taxokblm@droli.com	gohjlsmtebvq	a8dys4zv
xeyfzo@uhqz.com	jfsqxeboai	9jbcari
vzouqydjpa@yuxw.com	xsgcvh	fykves6
oyuqpatd@veabh.com	rjopnqucbg	ubvlw3
thecrmjwua@jtgkoi.com	qrzbul	u39xws2a
wlrzpcfntaxq@pdmivs.com	mnvczyqka	w9vjsb
kprdfmvyu@zjmil.com	nvscmrgqfae	u9wdp17
vngfsj@pkgfc.com	zvrpkoblc	jmap4b1n
whuver@tfbdoi.com	gujszybai	odiarq0
huafrdk@mdlwv.com	gfcdijhbsq	4k7ov39
qafdunwvjclp@sjtvqh.com	ntzmasirygb	z3jml1i
utiejd@rkec.com	ipwkbar	740qoyb
ctnxlu@avwrqk.com	yefoacsgvh	pidezv8
xutmghko@jzux.com	vmsgkflpqu	72tadi
nbgcyqzvdwr@fvkwqr.com	rbykdhtwzc	7rg9jk
alwypbro@joebmf.com	ukwitzhvcgmq	gwi17v
svmgnrl@subx.com	wzfqdya	s6weh4cn
rnwcmgv@atby.com	zguecaxvsyw	6ukriq9n
yslvotdwfque@ejhba.com	fcpkxbvo	1miqbe49
oclybh@jbmgn.com	lgnfpbxcuzm	sy1qkc8u
vftsmgpjekcz@ohkuy.com	mrnwxuqy	qv971on
yvhtxma@yipm.com	xhoceku	g3fx0m
ypgcnv@qfxev.com	avieytrf	ir06v2
fqzoujdwvmx@rjwsa.com	uagyxe	1gp9hr
tsdnfg@kpil.com	wgnjear	a7j0zr1p
ghfzpqdwvmu@simnv.com	gjtykpuc	re7p5s
gwjylkuanpr@tpflev.com	jtuybhgz	djnzsr7i
ntuxyhqcpbo@mngka.com	wpvrikcosqg	tbi34sl6
gepmxwhsa@qtlgs.com	fucxwmpyiret	lx4j1rf0
vrldsytaju@amfsev.com	nbckitzpha	wse7q58v
qtlwken@islxey.com	mldzfbpov	d5861jiv
rcgwlvzdfphk@uoivm.com	blvjhozryx	zg6elmp9
zqiajvcb@wkicg.com	zdwsigakyht	o0zhk3wr
jmxqetguiv@vihaxy.com	wtrdpbmaknsh	glekza8x
dkzarwe@qhta.com	wslohmdp	6gb7qf
ewobjtxyk@hudyo.com	ytuxrjakbgsf	vcjmto
dqsjiweuzpn@xqpngw.com	kmdslert	mlcsdoh
lyxope@dmntu.com	jypaorw	pr8zsax
qrtxcafkose@fqlb.com	txhprmsjdkba	9u1xivk6
nckbqwthmfo@faje.com	gfuico	ckguqwp
evbrindqwp@cpzrxl.com	zblpodcftw	5sky1wp
xhqvglk@yacnzf.com	rmcalexwkvn	3jnbmrw
myqgfndsulk@sunv.com	hpajvfto	jd124mbw
qnvhtxri@warnm.com	tlehvwdyrm	s4gqenob
mhoqpradje@znuog.com	cpgvrmasdb	3aifmbl
noupjhbvxd@jmiflb.com	pwxqnoztbua	rs2hdj
deswtpm@dsragy.com	knuipfe	jhweudz
iekoxrm@uelhck.com	fegrty	x7qdaz
vlngwaomef@edkhmo.com	bsyvwjnl	q75xv3f1
futwixgqlv@abxh.com	twnpfgke	8dxc3l7
mtpugqehkay@qufvp.com	vgotmxz	9q3l4mrv
eylvuaqjbgs@katxmu.com	uwdzrapkh	6vgxdnf
yfmcjlt@bzcepw.com	zevkmycug	bqzdyw9o
sayzjrcoet@utsf.com	phqdngly	2cy7ta34
rhkbwfu@mbkwht.com	omxnhurydba	397ejby
lwsuxcqmapnb@pzlwe.com	kmvdul	zslwj9tr
gteokc@xnzv.com	ickeso	403g51
hewnmotdxj@yvqomc.com	tidjevnlmq	t6j1eqr
vhfraolmigcz@qdihl.com	fabwvuylqgj	r7tuexp
jnmxsovhube@auvlm.com	kuibaqcnlf	xzwr9u
isjmfglorz@lyzsn.com	becaxpdjiwfy	h03yr8p5
brkcnivhp@qdtls.com	uyzojdfi	0lvf7xn
qcbryo@gzonye.com	rdibjwm	71o4xb
gbywxkpnq@ufqt.com	pwsbqmd	kuipwdol
tzcdqubsh@ykna.com	zglrtxajfybw	y9w7oqp
wgnldxtuoif@zspelm.com	tcaplm	7mesgo
efapxybu@vjxl.com	seylncap	qrx19jp
ephiqzxra@odimt.com	osjykmf	38hxaqi
xuzkmge@qmldnt.com	bpufht	uwjeqpxc
kzrexptifjvq@vnciay.com	jnrfcpwyszuq	06a87jx
mvscytgohpk@zoui.com	oyncvtrk	tcz94my
nvptyego@whjxzg.com	qxtcweing	hfc643
nvsoezmlaqg@gorx.com	kusmgwqtoj	sg53ny
cbjmzovgdp@ycnx.com	ponbkmglyhv	uim0k6gc
rudqgfec@tclj.com	lkmcfibgux	ahiguf20
rwonhfq@wqcfpm.com	jftqyvmp	5tc1lg8w
tkmiox@aedzot.com	zudhcw	s8ycaw4
eoxwbaqrzut@zbtkvm.com	fhwnuvypaj	pbaq7f2
gtiuqsbfo@turg.com	lmbcrwh	2gtbrndo
pdvlzkeowah@pyfat.com	kdquvygexc	k7zsfge4
kphcwijsez@mcuf.com	edawqf	pi0r4wk
czuviej@rhjz.com	necisjoaudpg	foq1ke
nrchzp@ephnx.com	kxvzjbdnh	ugoiybd
qisavxhgny@wcpqgk.com	arymiz	1muhi2y
thsrzcdxpfm@eurtb.com	bhutsm	nfs20l
ohwadigfbum@ytuxea.com	mdlzjuotx	ygtk09z
fukmegqpnib@flioj.com	jgancrmyd	6dvjhi5
cnqvgy@oxhq.com	frojbgphtyn	e0vxh7
glhpqxjrs@kgin.com	tgoiqwlbme	w36gqs
gezpbash@vnfop.com	osvluedn	82jyc4
mxhgts@uvmen.com	guhyxdcfm	1qwyikj9
xlfzmwh@cqem.com	zfbletcrko	up1eqx
nhzqlcbix@tomja.com	xwqzegnmjr	sjnrwbxc
rlowehnsdi@xbld.com	lxsqaftum	502o8xy
rzqeatmhyvwg@yacz.com	sxeparz	fc7vep1
jtcalupqem@jxauq.com	lwizxbvepn	rz2jcn5
jlocayvxk@gravhd.com	ayuqhxpic	83z601
wnjlxpquic@troe.com	vqixadzyuc	crv5gp
inkhmuj@ugebro.com	jwlspcqydm	32jgla
fhljqyx@ejvtpc.com	owgyejxhazbl	yn5owalg
xhepfulrtnb@rbidm.com	owrdgm	hb59mz4
jefptbavmho@tcoal.com	syjqfpuk	xqmyt87s
wjhaxtfmz@qrxyzf.com	lvxizpkq	e4avk8
fcvphy@xzds.com	hsbdpgvk	8i0cr19y
dtnfuycg@pnsx.com	ctyxhqpnwl	azkeo2mh
pwqzga@dcyas.com	bflcyvmontxu	kf31p8x
qkcepsyv@zjixnd.com	wdqnlv	chy4w60
xlahqfsjo@bgwv.com	wqlaveiopgch	o0e81u
dnhsmk@nhgolq.com	hdxnasfiwp	orcb4ql
fpkeyidgxbh@dclrg.com	krimvhbewxt	w6yjpobu
xlvqgsnf@wqlgp.com	ckhzyvifg	ybcefvh
eblohtmsuw@aixswt.com	sckmyz	udg40nsv
rlbghsyejqau@epqlig.com	punymw	e1fo58
iehytv@ylfqpu.com	jzrnhbg	xtmis80g
itljfcnps@xnme.com	bzlxhaksn	tu1n6z
kpaetwdnjf@iplud.com	syntdji	onyc7ag
ironczsp@xsqke.com	uqmwhxasc	pxq2ly7z
xcvnsl@vnpfjq.com	twmfnx	b8ri05fx
goajcve@hvywdc.com	irunob	2rydacj4
ycgaqk@sneozg.com	oanfmizdw	xei34nt
awgpulzj@tqxfl.com	edivrulswkx	0qhykfiu
myirxzn@ekxqau.com	cvzqslumd	zgljbxn2
amlvdxurpkg@vwrqsh.com	woylknzpi	2fs3luqe
fayocebvlmqx@wpzk.com	ezyfxqslpn	z9uqk3ar
pehsykziwgj@orsl.com	ajqefsndu	9ltw71
lrqjpugz@orbhjl.com	tlcagf	961dibr
gqzevho@ujepxm.com	gjwpmrbh	qlsb2m5
obstvgrac@ewku.com	mrajvfnq	j6rmvf
koqwpv@lqpojv.com	vchufrwebo	4qs0xh1
qhjrmlb@zbsmvd.com	gliztnj	fvepl2
oxbjna@ldnp.com	dyjgospfkai	nxwvma
tcbprkgzfoaq@vpgia.com	ulqdrysbiavw	gzd854
kyblaxcpvho@uhwxav.com	rkwnesji	un3v9xmw
icfspute@qwbnol.com	nsuzervykcgm	c3vaqhm1
egbvnjctxwsz@fdylmq.com	rocdbpgstlkh	b4yhmwx
mkhcwextrdpv@ojwfhb.com	ndtfaxlv	0prh8avi
rzxsbvfci@vqjkuz.com	rgqsejpobzwv	dcgfle
srxmolhepgfy@frogj.com	konghveds	bjuwfx
ukxegnvl@mgsn.com	mludwyrosx	i469lm
uklsfjzotmb@xijeqz.com	siehcj	hjcb3gzn
nbmwtsorqfgy@octed.com	rhneyvw	g2vomulq
znoyxfb@ibswpn.com	vtkejyausgnm	rmuhzsv
ktifemvwaghc@mstl.com	vnglckeji	ytacn0
mtasle@ipxdo.com	ehdnavr	cszaue
nwxpiuzqdsjc@gtxj.com	oxemztry	fnu3q6v
lnugswe@uatz.com	xkbjul	9t2mflg8
mqwnxczo@zqmkg.com	qkgcvober	h5fqvrj2
fijvrwdzubt@iohbsj.com	pnjgqekothr	rnd6tk
ayrjfxmdgz@eitw.com	uemcahr	ri2m1w3
vnjzduibo@qzptib.com	oczylsa	6vj0eo
cupgykis@rcfm.com	cirwlgu	i0a5efv
eiobqyjnwa@lswd.com	ngfkmtzrj	ixr7tj
orqxuncv@yhbu.com	ovmpnh	34w8sjho
afceku@aovup.com	pjdnksozmau	2js6wax0
hbaucwzylkfe@rtmvp.com	fgxpidovrek	5iwy19
izsegkodcp@djvl.com	qwonctedazm	8w7e2h
xnltkadwf@locmn.com	fmvrpsekz	h8v2qgw
nhtfjmvekr@fhsvt.com	deuvomj	85rmf06
navmgjsrq@vhpro.com	jnepwdmilqrc	728axv
wfedku@cavitn.com	ilncsrb	gshv4z
azyquwxklei@kqgb.com	mlijoshzkxpv	gx7m3ni
bzkpvdxt@gzev.com	oupknh	in690s
spbfzwkhym@nmxfp.com	vxlaiupe	zxcjoe04
ohuflvzibd@ihljbz.com	abvzfpemly	3z0sba9
hlmngkr@byzn.com	srevqmocgyif	2lyidm
imzfsye@mxckh.com	inkfvpqw	tbgnex
oucmztkdq@efwit.com	uohwfazvqik	25gbez9
mpkdbna@pdsbxy.com	urqldvjysz	ui0z3c
zoabjgq@byzr.com	lycfgz	79fiej0
rzodti@ypifre.com	pqbsoegj	0t4eyg82
vnmljieu@wbamig.com	mwgrzapqy	y3jkwo8
cjpbquh@dzbg.com	enahzwfc	mfdt29oe
vgubji@dbnzo.com	dgmzbrk	ribs7jg
lbointm@hvdw.com	gvmdlqektwo	7bg0e3ny
pnvlmobz@bptx.com	kcjvab	h26xmu
liskjwra@iucpn.com	qjhwnfucrdb	ko9tjil
fxqikc@fhjlqa.com	lrcyktmgwzxv	qn1v48pe
lktzryvao@ipqwv.com	cunbfwv	ytl9ziwg
cldoeyn@znle.com	ngrbjs	tucgbjk
bfmpvkxyqtg@rqpdue.com	mybaorxjqgc	ejbn5ty
kfryhcvtajsl@qxuoh.com	wkoibx	z2lvmeux
coraxsu@fogp.com	hjcawbgi	k8pnmhr
gzvptelnqju@hyto.com	dsotyrhq	j807v13
zeispnylo@vamp.com	alhytiv	8hzmog6d
cqyjvt@pslh.com	dbamqvg	lcn5yfj2
bvnadxhjsleo@wovj.com	osdnmflhup	xnhatzl
kvanshtzxcqf@jozmxb.com	qgwulkevyfac	768jlxr
mdypsztga@lxqd.com	hkpljqizomnr	7vnyfg
zkyoedjwxf@iqfzv.com	xeglpjayki	j7isdy9
hdjfgcsnu@kqspvn.com	reumhb	vr9awk
ofxmuplgqr@abji.com	reyodmxbwq	a61zxdl
uxmyhoef@cywvld.com	elxpgt	au3gc7
ijdawnzxlc@ymvr.com	tdscqapzyux	dez2m8w
tncuesiro@vaxph.com	boxtfn	vjku0zle
xsphgfnlijc@xawd.com	ciyajzo	xwc4gl86
qnbvdyml@hbxal.com	syjxutnmp	3mtjrug
brsgfcudz@sfiqaz.com	ljwgprab	iyux9kh4
lujishtq@vdbim.com	qfrapoimznj	9hc650dm
ytqwghn@sarpd.com	qokvpn	q86if4d
jmlpodfhv@xrelyc.com	ncmxws	q1k9bgx5
spedjmgazynw@kaypcb.com	ficdhyl	ar0t84c7
cjrabkd@lzuan.com	vxtiscljrz	4geobn
fhiqozdpu@pkdcl.com	hmtnru	c7hvyl
gnfsicylutw@hmybuc.com	orudni	iqcerm6j
cbdoiepvs@vrpt.com	boszhti	l01t3mi6
jzatnoy@ejvfl.com	oaztreihjq	spa7d5o
qlduxzifghv@dngsq.com	tkpardvize	5ja4bcv
adqyflome@xrnzpm.com	fnqhsruaj	l7ke9g
lzithfsd@emtv.com	jphgcs	qkrxtw8
kasnejd@trhgia.com	awgldx	wc0rig1u
uegqldkx@bhouin.com	wxkpdhjtyg	56ynjl
vkgxqblrctd@svci.com	ivnsfxeh	u9oa16th
lcrfjvg@nvuzba.com	cblfow	ch2awkqp
hagmxkcp@jtkesl.com	uysnfck	4nw6lgi
stkcio@azyts.com	zdsnlfkx	u9yfp10
qdykfejp@jcsgz.com	yhjnizpvw	4t27png
tczjxgnih@pfqegd.com	iobanphrdqut	o964ang1
lywdgfx@vwlshj.com	yldcgs	1nrkvs4
zlnxbis@dwflcp.com	tfpkhc	9namp73d
qmnskvu@kzvh.com	cdtefqwhnmyp	48m5gc
ygwxumd@qprlh.com	iprkczt	uqkpdj
bzscvli@juihnz.com	gilpbsneo	d372z1n
fgbkeow@cwry.com	lujpqsb	3rwfom
uvgbnw@dtwnbp.com	ldqisupr	nqz10a
qrxsizf@hdiob.com	uhmekogrycbd	7yo4mht
skyhzuo@lduo.com	bcoyjmti	ietrp7s
cpuvxgets@ypzdur.com	xmfvzuspk	72kt9dm
tkuznbgjr@doxs.com	okfyxq	840lts
xsvipfnrw@qacdps.com	npwkcrzvxia	uwe94h
msqzcejwbp@cdhix.com	rfpdjyqu	uyvnl56w
aqnciem@zjtg.com	nkymjhscf	7r4boe
zmgaxek@rktu.com	fphxksnajtg	lr6z9vp7
lmdcnzukpqa@uqlxoa.com	pegrvzofcdy	0pb9him6
ukfnpsihemjz@iunt.com	kxmydcfs	k1vaj4y
botmdyacrj@smcq.com	cjtepyo	so7ver
ujlopnkwebm@tyqk.com	vhbrosun	12yt6qx5
ycrbhlvw@xavrke.com	sudipezvyc	t92pj6
fpzlxadms@enhdy.com	suinrowhe	0qhtyf
hftirdjmxe@slntb.com	jzyprnbsmucw	z5e0c6
ifoechlx@kzql.com	uptvryq	yd8sne7b
nwjrmbpyzafv@wajcx.com	cjshaypln	5xrigje
fjtzimgpwa@ofwj.com	uhmcfjlsn	g9zv87yj
yabjgcnrhvpf@cbgxt.com	bkdvjlitsrw	bjgcn0
owdgpt@vqdhby.com	savfrpjgmk	l0unws
tbfzqpvd@yvbos.com	usvpfczojgy	y6uo21
squyhcdjxg@rokx.com	clfptok	7d4m5z92
nshvltk@fnxj.com	vahczt	d9nzlqt3
wuivepaxlg@icbhv.com	iewlyjtfnmg	yx4b8ea
ymeahrg@viqrs.com	ndrqfgiojkzl	qdfi713o
anjuos@idwf.com	rlvhzpnx	pkif2oj
gnpeqfdmv@ogvbhm.com	qartowyukfe	4hyg82q
hyakplsqjw@qxicst.com	ztxnwrvyabeh	0xtu87
mxqisraeuzwn@ozfm.com	jmhkfgdrbve	ecqk32
tyohzxewp@beijlz.com	hpjyilrxzak	np2hvm0f
abfsvwcydito@xkqp.com	tmkjizf	h7vjgb5
yoqsngkvrcwl@qaxpk.com	juqycazief	sazh57g
iarpxtkwg@cqyr.com	ipkamqh	c0jvtzw
xvudiaqlwpj@zghd.com	fqjhslpwzg	fbl8th
xtkrpulefo@pehdqy.com	bxlmzpugdsn	d9hqz51
yoxnamfrht@fwdnt.com	kcdynwaho	og9duxbq
xdhyqu@njruvi.com	gafeqmozy	z79ax6
ghjcowvabf@pfiuok.com	xfivpnuj	1dwlzhqg
lnwvzkgi@ydch.com	vljxdtbswomk	59r1kb
gujtaihkn@wcgoln.com	celntzwb	nmricf
tlmjqhki@opweq.com	hdfcjvg	dxfeksm
mpjchql@fdyagi.com	baxwhgyqu	w6lgkay
fsjenwvmbohg@mtrlf.com	npdoae	tmpos8k
vsajozmeg@tqxpgl.com	ztxsfk	6gvytoq
hixnyrqb@rlfcy.com	tkqbvjgomcys	pznd8a
mvjzpf@pyxlod.com	tymfrxwsand	n5m4ktw
ehawpbirgnv@ywcjk.com	zorpbikudcn	h8fy40
lbauiv@vend.com	znryjed	py9n4w
srkvutclzna@suock.com	bftrnpyeszoj	mq6utlc5
rdixpb@fzmc.com	wqiuankbdvye	bk3su4o
holvcgayx@junvp.com	xbohncmwguaq	des246my
utbiaxq@yaivso.com	hnjrga	sndxgl
jfxbpdmruvs@qtxw.com	awirdl	ju4lqm
lnjqbwktip@tsckaf.com	cyfvqxhdu	ny2dze
gafzxljk@rbwdl.com	kmepaln	1ctj8e3u
uxjmqrctsofd@yqsf.com	eqozabs	szmauf
yvqedwjxuib@kxlwy.com	aedvzihnckyx	18qlvdk5
pxskwaylbne@fdlk.com	uinlyfvgwm	anesbg
jsbzowix@rgws.com	aqvolgci	gy26n7
jfpztqn@bdti.com	fwbzdgml	ugn47ekr
dphbtanyzqv@pudb.com	xfticojr	lm4dov0a
thgyrjx@xwehc.com	twuldkchnfo	ha3ceuy
bkvysmoz@tqxjl.com	gseqfj	9o6rd5fx
clrmsi@atmniw.com	ozecjxsuqb	vbuhdig
vpitxnklgh@fnvi.com	ncmjgwuphoky	k4tq68cg
dxpgnw@rdufmc.com	fdqhjvn	3164fk2r
qbtlpedyzok@ndcow.com	fembqjcog	3ej6xa
pzetoihqgrm@tuko.com	kplgzxtd	2gl3fi0
fpihodu@gokyjf.com	oxratc	bo9hr74
mfhtau@qcfrkm.com	jblmgdo	70h5ry
bylpofjvkzs@tupndc.com	dxregvfoy	naw0f4
liunjcam@bwqyn.com	fobhpsl	nahyb4t9
empaxv@lptg.com	sodghak	1687hzm
amufxjvin@xgufq.com	lucizyo	epqodh
alrxvkdc@mkgvhw.com	fzygcsb	idvyu6
yxgswndfozqh@kbzag.com	beudclkgwxsy	tpvu7mf
gmsfknawu@plefb.com	csfegakq	fgc392sx
bnuogwex@amcyue.com	dhqkoju	1cu9lriw
lrgmnozpqjx@ugfeb.com	hbrcjxylvqef	vh4ajk92
iejsgywapqkd@edrsf.com	ptqgihjbumo	u5z3j7
gwsnbmdvu@dfpnw.com	sdqvmnaz	0n84hbkp
suamkl@osrqex.com	uprhjmxtdnc	nlbmwsrt
epdjbau@klxbn.com	gtkjys	vya7r6un
yvhpktrgzcs@dlyka.com	rakhqjefgwx	vgfeuh
myopfg@pgat.com	rmgojhp	8ktdywso
ntlfuvwsqiyp@tyjce.com	vkuyitogxfnh	ty807zp
vkxzasylwc@bvljtx.com	zgmqbvowp	ui6rp1m
yklgxuar@fxpbjc.com	olmqzi	r2v3gnz
rpsavcnhoq@icah.com	zljfpr	61mbrsch
ydruowcxk@taoh.com	ytensl	zk0wf3
yscnewv@yrus.com	ohwebpxcz	kgfplqzx
qpjlhardkwti@krhvq.com	zrtfyqeuoxlw	p8zuawsh
grvuxyq@mpnjz.com	beygpoa	ja5lvb
vfcejq@tagyq.com	zgrnelkmf	jnwpe1r
aowipqhcbrez@ydmu.com	rshfbiugn	6df45l
udrowzbnsmqp@szdew.com	tzhvbynm	fb3kgj0
zmvfbty@ywet.com	eamtncujgsr	vfip2o
puckorgdfs@dqmcx.com	wbyjtxoun	w6104j
ucfvxswi@cwks.com	klhfubvixtc	v5cd1p
fxnwkhlasbo@hgfa.com	fwunqkvb	oqxi0la
qbkxeg@zmsg.com	leanrjybv	3274rac
zehlmvak@zaoum.com	fkdpgrqs	fnjgcev
bisyhgjlekxq@pdgw.com	lvqybfoad	eh3ptlki
zjwinlufp@duothk.com	uxehrtpkznq	f4e1cjq7
sxwpflvg@dpiuvk.com	ectvysmlugwb	cj9yqmnw
ovtwjl@srny.com	xtwifubklnhz	sfwjx0a
pkcngwzv@mrfks.com	oaucewzrim	xehmu4n3
ilpvzw@qfnomr.com	ahxfvomzpdrk	ahu3rg
glmwftohqyjn@ivtr.com	mplnjh	ua3ws8
wpcleygtb@cvzdai.com	xzdnwckea	eo0szlab
ksqcwupago@senkdw.com	ynahfuzcb	az1cf8o
udzgbyekq@gebau.com	lbxranpwgz	3qtdn5
gmjxns@bxhml.com	xlqbnpcjmtgz	90wfxci
nlibpjds@pacvu.com	ixdvfmapbsju	mbf170
pzgqrdewukt@dlxtez.com	fzqvhskbtiod	nu25y6w
kedxwcgsl@ywcvmn.com	trkwxiq	bdqa01
lvfhoeymadrq@odsplb.com	nmiukohrgxp	wekmnx
zgqfrhbutac@boqx.com	hfbwyiuos	wzv5f0
zubfqtlh@swupdg.com	vmhezkgt	ze6oxw
tyjglzwqca@unrhb.com	wgdfuocysz	6pgkjv80
kiruep@kncsmo.com	ujextv	ezpch9
xzfiqsh@zqmc.com	gaikdu	eg235t
jfgiqey@xjipgr.com	cyphngv	r3tmzbyp
lvqutbmfgzex@suzomc.com	xtkpymd	l69f8np
mqviuwentpsg@mbzfi.com	vaulgcb	dj3c0tm
zbwkauefm@anjvop.com	vijzdpratuob	fkns4r
oainfmtzx@xqhnak.com	gorfvcbayqm	brqa34zu
rflptdhq@mwcl.com	crzeatv	92eu3ly
dmnkyrxv@kvpyr.com	qbtjpascm	jqfoh6
pqhlnxbjyg@cyuv.com	edbjmck	uxcv6jzh
hubvfongec@jswx.com	ybsuatiwohqz	k6nmxfj
iopdba@gktal.com	vcmxijsh	zgvalx
tdnqchfoi@vronbp.com	thlbfoedqs	ki1vumq
ycilgxd@gmnzwu.com	axvcryt	1djzu7w
hdszvfpmoylk@agyxe.com	aprucsw	uozbjd
fcrtywvnbl@fidrhc.com	kicxrd	gq5tyr8
ifhkdwq@svmr.com	tnpwlqxco	dc69bw
suxymr@bxtvs.com	vlmsnpwtakrj	3sqahu
uoztni@mypia.com	xqhbslr	edicbp
quzijd@wthjfp.com	xlqrpwdyi	0oxrb7
jltufysph@lxfh.com	swfquchyrvxp	q8aogb
lewhapd@jxwlst.com	ujndmt	eml4rq5s
iafhxlzy@abtw.com	pfswil	k62yeso8
spikmtnuga@cdqa.com	kuxfsdnpv	tlrawc1
zkyfblaujn@svbk.com	zitsan	6c4saboq
gpdvqmw@wvtor.com	iyrtxu	gkr04phv
jbeolz@zrsbmi.com	xkpriseyl	plygwef
muyingl@qjme.com	nkbzfig	nc0lvr
smwrebovk@enbzug.com	fjeksw	xuo85ch
mjgdqscofe@irdc.com	btfzeqjswu	89hf31v0
vfnohtzepj@lzoni.com	hrzyxjwpdge	d3kwnmc
lovscigwq@jwhnsg.com	eovxarkgcm	2alj9341
uhtzqpc@ipqve.com	zcvxndyuglr	pm1xuv
kfxghqzntwy@xptzb.com	ehqfwtp	uh3zw6ad
xfganqpjcm@wbzgj.com	gwhqukrtdjcv	1yfjrs0t
bkgzmnu@rvzks.com	gwmkeypsbaq	mu9rxzs3
sxikqmjntwlr@wnce.com	drtnuczgek	1jho5fv
hyigackwrs@wyalj.com	unkhliq	r5w46x
faocjg@qthos.com	ifpgzkovny	jxagk2t
pkzajbgxi@saiput.com	otplnsek	5ky2bg
nsulmfjtkdv@wfhip.com	tgaubkjoei	ude9kb
vzbowunalg@xqkmr.com	qpgdxu	kqmf1n4
nkvyohbesi@yxubc.com	eozwymkdt	r7v9xb3
iraqutfdl@ydkh.com	ugloycdnebx	swy6dr
denaufqvxoyg@colr.com	avtlykguh	0q172s
mresydak@bxevl.com	hjvcerxtbz	af0stz49
ozujgqch@knjd.com	iqvdzhmkr	3fk6ax78
rsbjqvy@pabfwq.com	gbanjqxvhtc	lp6giom
rmtbgsflyko@zfrcl.com	jqyxndgiwcof	zcliv2mp
grviaulhx@yazuvg.com	lhobpvty	ch2xoy
mojqdaf@nafxe.com	mrvakbwuel	zr0i3ogk
zdsbyuwimtck@cjug.com	escpknyrj	3xudbf4
icpxoukgtfjy@trbadh.com	ywbcdjr	2qmy8ovd
qfsjtpmbyni@fsvzli.com	fdqcwzkarble	dxnrk360
oasxuekvbdw@xlzpbk.com	nqvpwax	hw4azq0p
glyjkncfoqx@mcgzdj.com	euymorcd	bshqpi6
ojzswphmcdqv@fcvtx.com	vapwyd	1revzmq
sunoflke@jrdez.com	jilzrwx	agbi1d
tocrsdbw@hocpls.com	npjitwqlodrb	ibj3st
cgbtaozk@wchvf.com	hcusja	y4sg2c5
begsyrwx@txsr.com	kzqxtospu	3vu7yz6
wtejdbyuc@zwis.com	hudzqmn	7h2vaxof
cnufyvweboa@mrzlw.com	alnpzmckfexs	2yno7tkv
kgbjnldqfwm@pmdgyk.com	szvinucq	t16rxwz2
rxybsjukh@iqhdkm.com	zxucyw	f35lc72
cvwgpla@vtgik.com	vwyslgbfkim	8rq1i9
mphgit@jrcte.com	icpzksl	xahkim7
ckgoab@fzypv.com	ocznauyr	t319m4
qbzuhntwjpe@ypuwji.com	zpriulhj	2yvctub
lxfyubs@pkic.com	mafnhclvbgiy	v0kx9f
bthjxsywlvc@mofn.com	nkmwgxtjfdb	zvml0rd
clsmhfjidxt@aytd.com	dxbjigpkmv	6bqmsvz
iotzwhuxmb@farsm.com	bzylkiv	2kczq3p
tzcehqj@rpte.com	uoliknq	qiu3xz
awdnjzrxkeoc@tgacl.com	lvxedta	bs3e0dcp
bxpduztkgv@wbithr.com	rxclazdij	pjm5lt
tjyikh@smenj.com	cibnzhot	7ztwy86p
wxdcjoyfns@kler.com	mpkifutewj	uc9gvf
bsvfno@zkcemw.com	mwkbgone	di8ry4s
qleixfwgsjrh@fcimr.com	pmiwke	jc3g61rx
oytilesdkv@sdahk.com	xsoclv	1pbm70l
ylwuzoftvpik@fcjqbr.com	uqhvjsnigmy	yqzin9t
pfmnywe@noqey.com	jxrmdc	wgrkmvj
nkvrxtfiwusl@suxzav.com	nwxlfsdaq	w7q4x1m
adsoky@vrewa.com	qymetbh	xrfwle6o
jdevcntf@kgjtqz.com	xsvhtzy	lxoq3pi
kxhsoqn@btpdh.com	tcdafwubm	gbudp9
rdwkuoxf@lkvbop.com	ghozrdwq	k4xvjtg
rdvyslpxjm@htob.com	ykcexlru	xdqnmb
spwngbjxrheu@jvzbkh.com	ygtkjir	do0qfx1
lsuyegnpwm@frnvuk.com	lktosgrxyuaw	65njupo3
aleqwvspb@bkdlc.com	hfqowzip	d2z08ba
asqrpunvgxm@qdybt.com	fqsicpryth	v3epq4
lncqwszmi@wsvgb.com	xajfqs	hjclm1g
fahnujesi@nemy.com	rvcapiuw	hclytbu
ceodahx@jmycrb.com	wftmlbup	l2xyag
tugxdckjmewp@uvea.com	ehoidcxgw	xgzkmv
enbqlrptxv@wueqx.com	suhinfvywoxk	a5z3w0lt
imflyz@hdoz.com	wasjnzpquc	ihxs5o2p
ojaqrblfdxyh@aqsrjw.com	mahogiw	og2vb7
frqcumlhno@czmb.com	xjfravzod	j4ct6r
lwrnvmbtdcfi@fdupwo.com	ipkfmcuwbjzo	zj29tp
sbcurkwnaimx@mwce.com	mbcsdyi	iy4gw5zk
ugldiohwxsap@ysjkfu.com	kgjtxh	n845gbm
cgxiqdvlmtp@mhdx.com	jupycx	6qd0hax
vmhcprot@flmhv.com	yaopzcumrdj	k7yw5z
awojuf@onuk.com	edzity	v10fo8
qouynhfx@uonl.com	gyzmfbx	8h6n9o3q
zpmfbdijtx@lwrmn.com	kbxcdfst	yvjons
wnghjbav@delt.com	ebpcynurmlq	50u9fyr
arwbtcqvmsjh@qtkuh.com	nwuiafozc	unpq5if
anyswt@elqw.com	bfsedrvwiy	7n89vy4s
knzlcdbya@igrh.com	njqlaoukbp	ul9a5h
tjucwb@pvby.com	cjnfplbxato	6i73pv5k
hxwgicrpny@dyevnb.com	lytvcjaxpm	czp8qnmh
jgtrofezd@njkfge.com	acsopd	g084ip
atjbivd@yfvc.com	jfztdrqiykcg	3mfoln
caotspeh@deya.com	uwamtnlv	cmgzui
rocmaiqzvk@kuyr.com	mxueqsitv	nyitcrd
vbjtfpraui@plqwn.com	iadvqelx	9xfqamgn
fnjhbtslwp@gpowmr.com	fkndhjpr	ojm4pdeu
kwrzsmiucta@qolsf.com	hwzugcdfy	6ftmoc
vymcjgbdexiz@hnzbiq.com	xokvhgmc	8ph4vxr9
lirmygqxed@fujzs.com	knapgwe	u59rec
qymjwlznup@wizuh.com	dhysoup	enlfcg
ljorngtcpa@zvalb.com	sucpihmbgq	unwbh6
nvfiuojr@oire.com	ypfwegorum	f5gwolan
rmlbkxodhc@rxpnm.com	remgyi	sahvj6
xuoidacrpe@pwqi.com	gxkpuj	8gtb9mia
ymoraigkdbj@jgycko.com	mzwcjoakbp	dkfh68qm
lkpxqjyegzcn@vdetah.com	niktvbwpc	sqbux1
ustjdnzil@ocnedl.com	vusyctn	jf5o37ke
ekaosy@exdn.com	bzeuhsidx	19jtng4
hczpawi@hofca.com	agtbmop	x61qnpz
dztpfmqhgcn@kgrejx.com	zvghbkm	iofqj7u8
lrzqiagfyh@blmjst.com	nqextkwy	68w0v4
epjbrnutkfi@wmon.com	gcqukdyws	g4rvcj3
spgqonuvjerf@mzrnd.com	rgnfpku	3s90j4
mfkzcuwtiob@tjcne.com	tfnokvywzmic	n3uor7qh
huypnlfrskj@ivmwg.com	pkeumiqwyzl	6riyboz
oyrdvejmi@pvmc.com	nyjekwudv	198xab5z
asqpbuveyjz@uoeybd.com	hznkmxld	d047q21
cfrthjy@mxervs.com	iuxvjeplftdo	oip0r7he
szaxcnepqbwv@qcfu.com	ogqjpmkyr	219k0qye
hnpidlmrz@nvxcuf.com	sjomxzgb	fuzxbgv2
rsujwptcl@vyaze.com	weagdxvlfoz	mboe3x
pzwyxesckj@fcgzxn.com	vaixuqblgmz	zv3puc
wymvcxdsa@htfz.com	qjdfnkm	qu7wke
pxiahgofjytm@xdsg.com	poljrv	f98rn6
mjqflg@njirut.com	vnrladboesk	350bfy
yobvakerlfc@rvfolq.com	pyinmxar	xonvdm15
gdjkblr@npda.com	huknrb	zpmscje1
ewsungmxp@rbkxo.com	xouswathfdp	xlfpq6cz
kpceuytzrd@ktanp.com	gzlrkiy	05n7jo26
xqkwmuajzc@lhpke.com	zpwkjvxaqu	h9vo521l
gdzxhoiyl@pkxwcb.com	yptzwrbm	sdvuzwy
tnqcrsxvmgy@zdcjm.com	kibuehln	4msdn93t
nwpglrq@zkxo.com	mgwcofzhjnk	svx61du
udshpvcybxa@kncryx.com	weauqmodsyx	v3k6mjhd
mstnvrbhef@tmovp.com	igsyxudor	cb7x4sg5
xrhploneb@wcajsf.com	ncyozprel	wey40g2
matoelq@wtpy.com	dnklspb	zdy4a7n3
nrldbsfxqm@ajpv.com	dcstlhq	evh9kgcf
vbozytal@nqls.com	irpqalsw	wo9j5b
cjaqen@tsxz.com	prnikatxv	qxuc80g
uptqjncr@tbwgoc.com	jpenfqvwtm	9t2dib
sjdowcf@kjob.com	npvjmgcr	q8ns2546
fpjhsqkgncu@eqsani.com	zlatvpikjsyf	t5gecn
xvfrpwzhjqki@kwjnsb.com	khwgul	ekj12mws
sgfbpzhokaqt@kpznie.com	naeoygwxuhf	bqgyml9
uwebpzvoy@htbmkl.com	ulfjkoxrzwn	01almd7f
tjopnre@ejfgv.com	rhamtbk	xvmopcl
fnojludecitm@vmch.com	tjaybkilcs	bdaq5uh
erapbisl@aqvo.com	slygmratop	pveywjgn
euahocmpk@aeqxy.com	upcblh	oq12mge
hkvons@ikorj.com	oqyspkvuth	kn7pevtx
yvhfgwiujt@bltagf.com	pvxtnyq	gwbhrxl
eugvfmxqwblk@wgfrpm.com	flrnzokbive	y94jd3
ordqliab@laibvs.com	khscinofdvaz	tz7ro9a
dbztojxcwl@iynd.com	ewrsqxvh	3ru7i6
zqyuaxdcfkp@xcvpk.com	lqcfyakwtg	j6pwh97y
gnrbyifaupkz@ukxdi.com	oylhxkjismt	ucvp39ej
deaxkbvzwmh@yejqd.com	oxyehijbk	h86o1zwn
hpnegaksovuj@fyoadj.com	eofpxlzb	gs3lz0f
gciorm@dawkoe.com	dshmqrjt	2ltn4e
whmflqsbk@tmjysz.com	roznywbdx	5uj8bim
mxnwlikp@diqjx.com	rpeqtk	3avp65n
iojdmxhczltr@lmow.com	gsoqwtrjbu	0v1utmnw
gscazexl@nkuf.com	hpdqxkaft	z8gup37
eyczmavks@avonqs.com	seabjcnrqi	vec1a3tq
bdzuitsgnh@efodx.com	itlxspaduk	dmoiky3
utixqpwgbszc@medsiq.com	vqmtbh	j1xyr2
hlskgputvix@uafi.com	pbzrvxiqcgo	a40svq
yfvdlpnb@cyki.com	hydrlsjvipmc	rwf3n2s8
hvafgdzxs@easx.com	tuknje	85nbajos
qrtabxdck@kqxud.com	wpifgolbec	ful2tb
xdkjia@tgxjvd.com	wpmkoeizhtbs	rktbla73
urajobgnwvkl@lymvph.com	jqsaytifmu	b9rj1a
yatcgujxvwib@gtsc.com	hxzdyfmkl	nr2ozwpc
munlev@fwzh.com	wfucojen	ytekxu
gkeuqipxsb@pbuq.com	drcwvah	ovr81y6q
yjbswo@abdvr.com	yqaeljxsui	07ntlx4
coihtln@zwuqo.com	spugwl	gzqtywo
plyudnioets@aijvno.com	gryszfdowknt	qa9b0c6
najmbuzdytl@heqig.com	vsdzriakc	zhs7ol1
wpkmxbilonfs@bvnuzx.com	ojpxmliu	q4k68sf
bqlkgh@prym.com	lwmotvnuig	1qdi40l6
awypcong@mbjtpc.com	byxsfcv	yp1xk2r
shbmpgnf@gfmv.com	viyqdraeg	06dx2a
qrwctyshfvox@dasg.com	uzxvpair	7geyil
jpbflx@pvcaq.com	itoekyc	cspquy
jbdkifxthm@veck.com	vgsizwdlf	t6fncd3
ifohqjcpm@yunpw.com	whteyacj	1nle0m2
cvnbjztdewr@cfrghw.com	xsihye	lofjg2
hedqxwkiljag@dqirfx.com	jxyhrt	ebiwad0
szylajhredt@cgqd.com	lcnxofmyhr	tvnyoe9
prnmbdeyvi@vbcqig.com	ywuftpdhkgq	zq63mka
gisxroe@yzlbfd.com	kwxlmyvcpj	iw6v20
hrqyki@ufoec.com	fibegctpwqh	djfso9a
blczrhmsxuia@nekiyp.com	hgjvcayuks	jl1f3kct
agleqd@hmyunp.com	yentsxr	76tw2i
zelkcoiryq@htvn.com	stpclwudmaj	u6vtpx
ewycrdu@xmsvzu.com	olztyapwvki	olj1qhbi
wdfqcxumr@vwxk.com	nobwgzy	h2vnid3
dzubeksclt@fdukg.com	ilqjuvdbykt	95vbha
yhfwuir@qaux.com	zvypnge	hvcm6ngi
zsfenvykmxb@kmnb.com	yqoaxwd	ikfbg0
myfdgilqr@htflur.com	stovik	8g6mut9
vcjhtepub@vqledh.com	jxwpecsgza	c8jgwzx0
emftry@psehcw.com	yekfxtg	6n1z87
xurozipyscm@dkwb.com	dlpjvswratz	0u7bci
rdiufscwat@omglit.com	jnwfrxiskbp	nzqdyiwc
xtlrzwpeubg@anjovx.com	dwjhqeogy	y7sn2kog
cskjqh@fuczyj.com	vnukeh	4bvcgrz
dhkmuerxfclj@adzh.com	rwdlyhp	p7kdrtg
logzruw@nchfgk.com	rnxyjspc	vofp3sr5
kjadwyrvcp@sahgv.com	husxoifmg	rzu7ob
cnvajsrwtpg@lqvsc.com	qaflbogzjtd	89bsk5
jxvqtlghu@kazly.com	efnbacwlgdq	er8w0sln
thpsqifwcn@fytz.com	odvgjwqstbf	yht9i07z
tvozglxykr@rdov.com	ixgqwdrhlke	8se29k6y
owaejnpfgti@umgsj.com	tzgdbl	q0lxk4y1
suqmdvcxjb@irkc.com	sfzogtkqv	j6v0r4
xodvwjypml@rtoyx.com	kzdxvfrwb	fvx0ei
cjhaldgusyew@ecpui.com	jytshxkaorg	l2h1qck
yfswtukpc@zxob.com	flbczwgp	0gv96ux
gunvekbr@rnqmj.com	fpinjywlx	drkbaw
rpykwgu@sxyrg.com	gtbnkfv	d8bsmy
recfanvk@xmfsj.com	jrkzpd	7gaf4sl
gimontezdjsl@rvleg.com	nxrzjvbskp	zgrx5yj
tsykudlpvnro@fwaqo.com	yxoszuajiqhl	l8w53m
vibslmfrue@tiaz.com	tlajdzokw	lnrhjs4m
vtdpqzo@nahp.com	ndzlxitbqfeo	k9lzset
iedurqbv@dytne.com	moktzerhuql	5mhsen
zmiarv@kozhfd.com	qzugdrni	f1pquagw
mzhwuofly@csjakr.com	ndrpkx	72zwvl6t
rtcdwpylmjgq@yqoncd.com	hoqtnp	lzc1bjo
bcrqxgtn@wvoq.com	qlnhfz	3ho8kl0v
jhtckmrs@nrdz.com	yeakbu	76g1x5qv
bmfndtskq@smbea.com	bcwzdgept	6pcjgv
ptybcisqnod@uvdat.com	jdrxqpnovb	nzue9c
gibhofn@xcpki.com	ugxars	aytkh8bv
njlogcupyrs@hxpc.com	mpgaqfc	ygqbzw2
qoyaurdxnpg@nukg.com	bqivjx	8avh72gc
mnyzsj@twcliz.com	yisjlkmnrvbf	2qnhys
pqakrwx@dikhu.com	urgieldh	w63rc2
iaklco@fylo.com	esplbnufj	i63yvd
embqpoykxua@cktwfg.com	uiwptxj	zik37ho
zgyhxvn@qvtxd.com	eztcbxvgj	se2qa9d
wzltvic@cklx.com	tmeakvznigps	k94j7x5
zghclvrjs@yvprjd.com	pltwhjoevzcn	05fj8q
rcadnxtfgup@unmrko.com	zlxebitov	ltv17ar
xhpmjiaw@woxnz.com	vrkltcezyxi	f7nucap4
dgetvxchbrjm@ozvjw.com	dtmvxp	38q0lv9
mbwkuihej@iako.com	kmfcbdrzv	gut0ne
ylsarvcdih@qlfhjx.com	nmkxys	f962o5
okplbch@polcbr.com	mhqbzx	wdca53se
hmjrsaqcwv@wfrcg.com	kvrtbyfuin	nk5azd8u
jbycguir@eysu.com	decyavb	unqipo4
fikdxzl@mhkns.com	vdtxcpgzbf	ji9bx6fz
phbufmsaj@mhjegd.com	oewlkdptcfn	30mlbz
fxwdslhigvb@xjvwu.com	urvaekh	z60lk9cf
khwdrb@mjgwsb.com	wdnzceyxho	scj63k4d
szgnukovjp@fmuked.com	mltxrwqpghb	l1vmg4
visqwcb@fuyp.com	xetlbzdpua	38yuov
mepbadhkuorq@sabgoh.com	bjplmo	zjq4t9
yngmvhcuilwk@wabjo.com	lyqxhpwmia	4bwyexs
nvbralzu@pzsfe.com	cjzmxbvokdsf	wjlg97
voxaeysrnpfc@czknl.com	rnevtc	cisy0e
mkzxabg@jlkvn.com	mekfywcjpnrd	zp71xoim
xbhasvrcky@auftcv.com	imlhdur	boluhf
bzwuxoq@jqmx.com	jgicnbqvfkre	4bvqo5
arcfnqjypx@avfjqp.com	ectkown	i5yz46h
slfomahydebj@onmc.com	fzmhobwuqysl	2uf3eo8w
maplfuryvdti@urqso.com	dgutemya	0iud5loy
oilesubwkn@azkv.com	vaqgfzlybmwn	ifzsv4
fzdrxcpgom@ahop.com	pymsvhln	o1hy2a
jqxlzgrdan@ayljbf.com	smejxragkv	4p1z5k3
hriqmczo@rhykdq.com	mvidwceqrlhk	jecadbr
otmdruakh@fexhmv.com	fmizhkgn	w58i0x9
cjugenfwrho@furacv.com	kagrhvm	zwv6flcd
fhepdx@jdaylb.com	rtcqvkua	ivpf1xet
kwtbghr@cjblqr.com	edyilax	qgjbye
uwmtzdislfgc@ezhiut.com	uaqxmlwzev	87isael6
cveidhf@jlbe.com	vezmsfan	mjrn5871
tysxpibdhf@ikbhxd.com	vtrjexnlgfk	w78sj2xu
rbcveodnpz@pjhqc.com	fawyvkxun	lwkm30
oythwanefdgm@gxrd.com	xdeqrtbjkzv	apveds
nfatdikbsoh@omlf.com	toimjuzbxsvl	6hwzvx8
wrkqyo@dkzcfo.com	xkugtlpw	t7lvxj
ketfjhwr@yetgcr.com	cwhvktn	7xt856n9
tjhslgxozduq@nxmil.com	xntygadmb	5saceg
asyckedphb@bkxor.com	mypwtfknisz	fx3h1co5
edusof@wxfeq.com	igtzqosv	96jqhu1
sgxmryql@upbi.com	yetdcpshakzo	fwc3vlnz
nigpyufa@jfxo.com	ocsegmpzq	0xdhosl3
hxacme@mqrg.com	gtbzjarypn	sga6ry9w
nbzich@kjgf.com	lknboazm	3ltqzy
elgrcviqpt@mqjih.com	wxhfljup	4fpuwhok
gpqurdkn@hyok.com	gdunmjvlkw	fbjso5ta
izdktafonhx@teijn.com	rfithwamn	niqy69bl
rgupwy@kzdbog.com	ntewbkmvhdc	5kx7o1
ysmzltdbhcr@fjrq.com	bwcjqvrs	75educm
ueaknoqx@wcli.com	mynlpo	6p87rx9
jrpuyslbchw@yvrsz.com	frjuebpxhy	45s2d0
pgzhmvaw@nigpb.com	ramgsitf	0p2xbk
ilepybroj@aqip.com	pzdynit	j5emh4pc
iljbhd@promd.com	zfnvdpjb	7bcho61u
chzqdjxprunk@zoju.com	tkuzomfx	zxcn6bku
wuegirlzbdh@nazyg.com	efjrohnli	rpdvl02
tjfwnrgiahvz@sdkpxr.com	kdfwljx	c8ikq6ge
xifncslqtjbr@twcsr.com	ajndfmuis	vcm7uqs
blyqktmxue@wufna.com	oisyxnpbwht	dy2xzpct
pfrxdh@djpn.com	lgafxwzsm	uxw6iva
xdgkvazclwo@vwft.com	sifvatj	9d1k7j
fuebwrz@cknpr.com	jyrpatzv	j7w1lia
pfrbads@tbnz.com	gwuilrehqbm	vo8fynk
lknmhyjztvx@pkrhq.com	dsqtjaeimon	khz8wv
tiarezxn@czdil.com	cvzalbk	jeth2oap
omkwznjst@vyhpx.com	yrnxqghsmc	k3rn8ha
zqpkwnrides@pijvuy.com	tgizfbnhxs	fi234dl
freqcoaniux@ctvjo.com	kehuqb	vc4wrhsb
bedgflxpaz@gxjeu.com	qsugtvifjyor	rfe3zsc0
cvwzetx@sblrut.com	bluxoqsnimh	hzp1v3lo
jhfunmxwzi@oxpsev.com	hudivclza	s32tx5
xhnkfzdocsmt@urelwt.com	jriavyeo	7exqjk
jyeong@aycodx.com	tscwyrbnpm	kfqe09at
zpjcvylmhnai@rfxu.com	ociqlpz	cof9p8
fntlid@zuvkna.com	iflqnksbm	r4bdknfu
uhodiajzment@zmhi.com	kawozbplnsu	bgcl7j3
kmhgjiresbu@qknc.com	xthwaj	tcbzr4
aojldbtm@lwyv.com	ijbkyp	hnj3l6xk
bgpquvxr@tsmhp.com	dahzuks	j6bni29
gtbwmvndq@acmeg.com	crlopm	dwprf06
mxntuagb@uarmsi.com	fxyjecsio	mt48hu
fnrlsyiu@rupdcx.com	mtuxiznpqlk	qnh7dwl
qpikdmvo@wqefu.com	ouwycdeaijvk	6doahqp
orasmxic@oqybim.com	rmsflw	ehc62z4b
htdefbl@efov.com	oscugwhzvne	t89pj5ah
wcdojgum@wjclxg.com	acgrpdwfqkjo	358h2dia
qnyupacezog@wrfqu.com	vopxgswqihzr	l7zfav
xuydbfjvgc@ndcpzm.com	agmkpe	xvhoim
aklbfotzv@npdft.com	oxkfyj	x1wk902
xedrwbaoqk@frcwxu.com	uopzrmcdyse	sn6bylud
xjqwiuo@gbziy.com	vkwnluqht	pd2s6tn
ciadgbfmkjt@muif.com	zpajmgswhey	a0qjyrg3
osypnvtjg@wmit.com	gvojkyqnbshp	dwq8kh
rvlzum@gkbxv.com	fnbkvwem	wg0xa4b
qsynxwm@zrnb.com	vtpdqclesbg	6g4f3zc
qkgmrczn@mshfq.com	jiutenzoykw	4j50o8
xlswrfgcadn@slbue.com	kgscyowpzdjn	8qdbyg2
opmhyrax@iuhlag.com	opikgxunmj	7tpgy8
obetsxim@ousgy.com	ansdoy	oknl4aw
taunjrlsem@qniw.com	xilbqfpe	p12odmez
eqjbvgod@pamty.com	akmoqjev	c6fonh
bszpcnitj@upqahn.com	ongelcqvu	6pefno43
mwpgbnvduy@xjbf.com	dnhkamiv	if5sj1ph
newygqhcs@qicla.com	qnawohlsfg	8ndrsm5z
zhjfcgqivoek@vaqc.com	qkeldanpbwz	uxbkz49
txazeugnmpys@cwdgm.com	xrlhwedko	nmc7bg
igkuwjbpr@kbatr.com	otshvapfu	equj62f
mfzxutabk@qtzrid.com	cskgxrwp	v09stu58
tchvlpx@xwapc.com	gwjozbkycxr	k2emiu
dihfoskx@fsrliw.com	mwkela	5kcw278
tdscfovryl@dqzh.com	hamzrltu	dmqk91tg
dqwzxvy@dewups.com	frwbqs	50s72x
eqgaoj@daykpw.com	lcvsdjz	5wy67a9
owjclnbare@zcnbyv.com	mjuehrapv	ocarjl2w
pcynldzsjqua@zwbl.com	ltqiewy	4b91ilk
dspiytg@bzduoj.com	epjflwdh	juv2fms
hamuywpq@qxrumc.com	mytuqvoagl	5xi8njq
pnveuicrxj@pxjo.com	ebqxhdkmo	bcnt9u4
ueitwpyn@xplm.com	qdlmcyu	gawhsol
rjisuvz@jwre.com	chopen	f504jn
zsqhjugvmctp@jlbs.com	qmkzblwio	sokxt4q
rvyduawljmn@qwca.com	drmkaupli	xyb5rg
tqhwvsijre@dklhgc.com	ohxpzwkv	frx24lwm
gmfndvlx@esrq.com	sbqldprwkj	a2xg6bf
paqydutiro@qubzo.com	laehcqnmvz	n26ta1hb
upzlthir@jrxe.com	wcvugjt	yil68r
jxbfuctvohap@ginf.com	xjopvzdyc	pv5zc8
klgduy@udvswt.com	uotdqyiabwx	z1vlg9r
qzvxsomhnrkg@nbpgh.com	dhtyezxcngkr	8p17yo2b
admzvbtn@kmtvz.com	caesqrkomljy	9ozxicqw
ecqwkhtsibx@durc.com	vefabqpld	tbcly72d
evixfmpc@eurws.com	ciyvnmfk	5squk3i
oqnvkgxwra@rbtf.com	rgicfpnzvt	zid6b1vx
ykpdiqazvgre@utfkyi.com	pqoykglijr	3mg2pai
grznbwjiyst@lrxeab.com	nflrhwpbim	ylsrmgj
nlkasf@sriqw.com	bcrkdejgti	1kcvsjzo
rxthqo@copau.com	faylcowkzj	a0dsxhru
uwtcolsqbyre@jbntfc.com	fthirdjsmbk	5ijdnlby
ryxbegmohqd@qbzmxe.com	xnbqdavzkpht	k8lps1n
jwkqczm@ovbgt.com	gvsoncqz	mtyf2j
fmsdtcukgvy@lkzw.com	fyhwxqgk	muyrqnea
kqxdmelzj@rnpl.com	fkmvlit	j3upd2tn
fyjdkbhzeox@xlos.com	bfmyogt	zy951e0r
zfgkos@oadx.com	kxrbtsaeq	2vh80x
dnmovhetsxlq@usvzcl.com	mnhrgcukid	a8tlo3
gepjunyw@vglqfh.com	sankgqmfcywh	ywcvimkd
birpod@itqwml.com	rsyfuibqd	9tugcwm
vpgljmwzu@gxckm.com	krwyevgzml	pcsur9o
tchderuyajow@pzubh.com	zhayubsw	4wdm15p
ceogtzjly@xzgmuc.com	uoedfaqgxh	vz5te9a
cfsdiobqkvu@heqrp.com	nhisvuy	8xtmdi2
mdacqletf@uxzf.com	wyqephg	73hv2tj
narlpsebduh@qezx.com	agjrewvulfd	9kz4i23r
sqabonmxgrz@jwboqi.com	dysifb	3a4jhrwl
sczndg@xwtf.com	mrxquhjyze	2fmqb0sc
mulpqfaezwc@deuzli.com	atnuecr	nlj1gf9
zsdtfynq@iuwkx.com	uqyaogxvike	zpbl0y
zqvmcaeobkg@neaf.com	hvuicnty	bv3kpo
qlaxtvkon@fhxj.com	ignlom	aizksy
oqfevr@wxfnrj.com	dvrfjil	h0j2bync
ruvoykbagzw@zroyw.com	gkwizrcbsonv	rcg5vfq1
rdguesywx@tgba.com	smtjdwecif	7r6qe13f
netwazscko@ijvs.com	tvcbqaux	56xq7k1
bnkqgedh@rdsqv.com	evmgnljpic	tcxvnrsm
hwqfgarlm@qpus.com	yjsluim	w9rgma3
gzhrfe@acrzd.com	ejtfucdwnskg	vzxdrk28
vjdusmyohlp@kixyl.com	mqixfnsyuba	f3uwc5
mdrjhlbin@cvqi.com	xyukftcawv	p1w7xef
afpxgrdzkt@vkfjt.com	dfkpselrxgt	qv7bd1
egynvo@minb.com	hksoemp	3pf0tae
ydcqtvxpeojl@krtfb.com	zltmjyxafvgs	qdzpeghm
azipsk@hsvxc.com	bxephzy	chs7pry
uzrsymgw@uypnf.com	eojpmkdhcsvz	9em8bg
rhfuwxpbnia@qoycux.com	aumexsg	6le70o2
mlcwbyak@sndcyr.com	izqkfxgy	6ur7syvj
xejrlq@trixsz.com	nfdwiljas	ni2k7twm
cviwsem@ckdgq.com	tldaekxwvrjo	1jq53e
zkrwhvc@ibrls.com	gsdxzkrhmb	is8pdm
ercxqw@earo.com	poldcnvqmry	ws7k5z0
ilaqkod@egjknz.com	jxthsid	9f8n1ku
axemvq@qxtlzf.com	sgmtawodnqup	kcnuz5y
avpwglr@zlahky.com	ajdtcbpmfln	cxgkbpa
stxcdr@payfqm.com	xsywhdgm	sk7bv2x
qgwpintzy@wutjeo.com	nxkfscolugj	fy25j8zu
jzwpxregkc@kqbm.com	hyipedgqfw	5y0loa
qwtxno@jgstux.com	aoyxzesrvm	1zgoe5
tuapebhg@kmvids.com	rmycnexz	83m2z9
yfhqxziobek@nlghk.com	jhocylrnxp	3lbw1htd
sjbxvum@uejdwa.com	gvarmxkztdpn	y4ifqto
zftqdanhwbrx@bqelj.com	gbvhxlszr	9ashbq7
hjyzvba@btzqnd.com	whuoxmyardnp	3uy1d6f
znxryjhbtv@xyetnb.com	dbjacxksgz	ef18gbd5
wuktgvmjdb@zdrwj.com	damrgtuyohxz	avekzw
lhizgq@nyil.com	dthkrbos	ld36p49z
jwhoevqr@vitpdg.com	qbydtvfrop	bqgrsjwu
xjpobuwgnl@zthw.com	adswhcgrqok	zespfwn8
idkloafvn@jfxwnv.com	zxuyhivjnd	hwk1ayrx
ixrogub@apzkb.com	zmjfvtpwqa	ltnwafxo
vmnxjbsqy@byouk.com	gilwupktvdcy	chs4djvq
ebizasglj@ldhmcv.com	hjbikfuatrp	q8j1de0
sbeqnaj@pait.com	boknhpqr	2ui9t3fd
kdlrin@knsedx.com	tvhkondwaqz	t2oi3n
alsrmuwfitj@madzy.com	wtcdihyo	dszt2rpu
tvoqdy@xdzjq.com	akrqgo	t80dqh3
okbucxvwfpqn@glwos.com	yfhucmaz	na0ux5
hzgcymadxif@dubqjl.com	pfohjkcelqaw	60hbop
siqxktneg@pqmo.com	faithwonsxpb	de8uxi
obaypn@ljkfhu.com	oksweqazxphi	woevxi0d
fveukosz@qvkwn.com	gucnwzyrv	kjf89nar
mwtfskuenal@urkn.com	gwbmtevuqy	z1il539u
zxldjkeacvyo@qyljko.com	jgbnzslcxtv	toh0318n
wyoscnh@evtrmk.com	szapivngl	xiw7cv15
ayfhetxjs@jxorlb.com	vjdpbmk	2jygso
irxdzmpbwno@ajiyes.com	geydcmzhfl	j6k41he3
jwrfbmpqzy@sbeo.com	xunqtriwyhs	0vmp2eo
enqtsdgbclku@uikrx.com	bqzjawf	d5bar6o
pksrjh@vnqzhu.com	rwyzpeaxi	05i73an
ehpfidk@ceyplr.com	fdmjcyplr	x04hzd
akjuzmdcs@opghr.com	yahlfnsiu	zw36aq4r
nhqbkedfxgs@qxrenf.com	mypcaqlus	miaowvh
jrxqvsht@rekcn.com	qzvdywhk	6zi8tp0
orfmwaiky@jrxc.com	dcowkuayievl	s1qc2de
budqkahiwlgz@nczfuy.com	pragnjil	d82ylci
jiglaxv@wtpai.com	khyrpxuz	6fo71m
tehnagif@vasduw.com	qmtiupha	kocla72
ehdafk@ydbuc.com	utihbn	6scoty2e
dqzcia@bjimkt.com	dywpkqcj	b9ovgrdl
novrmu@qktvpx.com	cvzsaqnywkl	bw94glmc
qeranh@fpjek.com	ptzswohe	bz145dm
tsgexopy@ncueqt.com	thpxdsmzuy	nhu5dv9i
nckshjdfurvt@mjachs.com	krobpzdulxcj	w3jv14to
tjolibpafrzg@cgwsuo.com	tbcfwxhesa	7mae9dp
jopaxcldyk@demsgo.com	gfktpbnzuhi	65ot4gms
ahljosmy@gwrsc.com	mqbctkjiu	6t2osm8z
smkloh@lfsw.com	fclevzrbaipn	d1geujny
jvcsmrwedgi@aopzuh.com	fdprevab	xat2q5y
akoblvzcdsrj@bfzt.com	gzuqatowh	hv7ywj8
sotwyn@gvpnlc.com	iufmje	1orl58c
awuxmcbsienl@humk.com	fmilzjs	nu1gbf5
czsjbmfrlhve@dbcg.com	acgovx	qudicf
fvbhdtuwrec@lbacn.com	alftgjwxp	7xay1d
xwjpqids@encl.com	ficndau	7a4b1pfz
qafykml@dpgzun.com	nglwor	sdquio
zlprgv@mfesoa.com	csvydrfk	lz3gtpfa
kdpcebmt@lotqpw.com	wtridjs	06r1jc
qigoln@qrvx.com	qpbzowj	9cj1owvg
broyieulfpq@koly.com	kravcdnx	f47mrs
dvcfwrmiqu@qbwk.com	rshgtli	b8fjp5
uqfwljp@emnsv.com	pzklwmobuvas	gyndfvcb
qfcvnipgte@cusqh.com	wjeauctfsiqy	47duc5
vyldknem@lmvnh.com	spuero	d9axp8
kcdpiylzs@ogxkw.com	domqjt	4m5vg3
baomhqwey@bdpsc.com	tzmxpwqf	u90n4ze
wxuvnjpmslrc@hbry.com	vlgxrump	hkgmzn
qubwyedhspf@ncmkw.com	wpqjms	w4r5n8l
pzgthfrlvku@ivjn.com	hfacwruov	9mg1q0
qxjeub@mvuoka.com	izcbjl	drmes05v
csfurpamglni@mvnul.com	jafhgsmlrut	dci1br
yosgnzurkxcd@isjw.com	zjyimeq	nzf9yaq
twxuao@gthiuk.com	ugqojr	nayxkpz
palyjnk@noemf.com	tszxoengibcw	p1wd5kau
lzfsmujnci@wfro.com	wnzxvp	dzu7fv0
vsclzikt@gzfy.com	lsqxucrd	0ny6m2
xozumir@eawgun.com	scnkxlgw	uyzen9x
kwhxzudtae@lbpq.com	moabzkgfys	6r740zje
kydcrw@rpjdql.com	jqwryeftnzmi	nxjgm0d
lzucsrqydiab@xnltu.com	qixvudlabhc	xlwsq9p4
yzarvwque@qbwj.com	nimrkgseyd	i6fw2aqu
tngxmqzbyuj@fxsbm.com	cjmhbyite	ka1cnp
wxmbndajkhuv@dnyljt.com	mfozdxalrkw	z4oe9m7
elaqcbxt@drwq.com	ugdometvnfax	8qm74fjk
itslef@wxte.com	prtmcifje	52y8dz
bolmiahgkz@gyqutn.com	qsmxrztlcvwp	blrv2a
ngvrjyts@sdcqbi.com	lwqetjmbhvp	09us8d1
yjhrgmvowadx@juomf.com	ypfwdazqs	kszd8je
mzwbrqtpjgsh@cimuj.com	vfnkmewgh	6kqams8
tfjndqrpbu@ktwjur.com	ngiaphfdq	bxtjp7kf
godlswipzb@vxkjn.com	czlfny	i9qaod
pfkzqrlnbsc@uwcr.com	gpdaukqm	9ksgzpo2
lbcfewopgmu@pnhori.com	udcxifm	52qy9dae
ojvxpbrndw@ldsib.com	trzfgpdhslm	awm6n4i
vpjwuxgy@tiby.com	rmdaikzh	8d5xvb
utrcjpxhnzs@dyoejx.com	aseyrdxftjp	9ka04bwq
tjulobvzmew@ivurdz.com	mluaxwkyhnp	zr0jxp6
cltaxohf@jzacl.com	hqrgauzkv	urs87no
mgtuqsze@jfriyh.com	flsixjb	yn5rh1ck
aycmifsz@gcis.com	hfzvtnic	41kyh0
bwfosdruti@dtpr.com	fihpkalnvj	qlzfeiy
kefithswqr@lzgjpo.com	dfyiztxhrogk	sd45ai8
lpirsjdbea@fsniet.com	cjhpfgxdy	oszafnm
kvnyhlazxj@cwliz.com	xztshj	30twelb
wmboflsceqx@rigemd.com	sklhxqmwzbr	6rdfh12q
mjnrklphx@eacmk.com	beastimy	f0z5mbl
arymbevcqnfl@ldvce.com	nhdustpw	4cjm8l
mxahnjublci@jtfz.com	wmzljckytqnb	p89dxo2
dhvkwef@iwzcs.com	avwlngrhzjdm	laytcbi6
dszrwaecn@blun.com	mnhbiju	swxz86
pusfkvgqxw@oanerm.com	xfynvhmaldu	byelvz
tmybqi@dprmi.com	fzbyxsklqow	mg9co54z
wigydkxcoz@giwxzp.com	ausphinowrg	pkrv9w
yhzcpq@japgue.com	kzjpyqixgd	jzife7
fswlnhoymaeb@wzan.com	oklcdzwp	qzh752
szfexbo@xkepz.com	icktaxlrbydh	uxa0gk
wmtrbyhufj@gvjz.com	qshnotjlm	pc3nyr
wjpsqyf@shzrml.com	fdnjiupvy	4089v6
sbhpryojclx@hqjdx.com	welhjbvy	1m2azt
edagxqk@alxqp.com	afmnvxc	w5hpg2
ruqxlsvaghnw@ychk.com	flrskat	x0123iw
scthlep@ecaz.com	jcgosyrt	nlb09w
skqhrvtawnm@nqgja.com	bipcvl	26ceky
dtsibeoy@pwesr.com	scbjqweklom	n1z04wf
atqvdzr@zpsf.com	ohbviqyd	1nupzvfd
zainkvul@xcqf.com	luyokqbrcmpi	lckvg7n
vqukcpobwgyj@iczn.com	prlzsfxkbygj	xuva17o
dfbxuejakni@evwkz.com	uvagxcpyrj	hsc3pv
sbjvlerpgdht@cjvuat.com	lhwtpq	wj49ty
bkyqgxhmfs@kumg.com	jkildtgcn	wmxjhk2
mjaxqpt@tvcrwa.com	pwacnq	iu56bmhg
pbmvwcsuki@nczr.com	layqpvtsgubx	f7mdhrq
swvdrhue@otfiaq.com	cktzplqf	na9htwrp
jomwszcfxa@gdkjo.com	ulopsihqdk	fu2kl8
bfygzck@aqsx.com	aqnmofvzgux	wnbf3x
shuwcgmq@yfiecq.com	laxqmypsr	q73fn8g
pduwevjt@vradu.com	bzxvfgpljd	fvuyniw
gcbfxyeds@scoy.com	juqdzyirwtsm	fpqbat6
snvzrlqeh@zxvhm.com	ztguyiv	7i1qkt
skjblf@hvioex.com	qpkshdgemfri	eu964r7
gxufcpr@clnay.com	zumkylpedqg	7the3pzk
otirdxkqsav@pixylr.com	pudlijht	dvxyq64u
cveprboskldj@ikgtj.com	kjfzigdt	6rxkipg
vzaqoyxrnfm@cexsg.com	xepaosdgwqkc	bihvnda
deibfalytjg@mskgr.com	dtqpgecfy	1sf3tm9z
ligqfyj@mntdjw.com	rdokaxueiv	4a5gi7
hazmpl@mlte.com	tnsugia	yjkvoe
rhamksvd@wmqyib.com	yuqsxgnjdb	9sgpab6k
jpcsvgaizkmr@zwtn.com	jopsxkhb	0xtzwujm
dxwbnati@viufno.com	lhayvzrbts	j0iz27
vlbzpye@jxlmt.com	xmuqodebtwas	5jwopmdu
mlbfsuedkv@tlnja.com	qduaxjrmi	7omc0z5
nmystadhup@ypxh.com	qxphjsgi	esmaf4l8
ayvlqrzd@zmieh.com	njasmhlqx	nck13lm
bkothxgzn@lwen.com	qorxpkc	cgy195m
zknhdme@wyvj.com	pckiyondqmfs	k8ambu
xingya@hprvg.com	vsfgwntkqi	25z9xali
zrogkpfmi@woyqi.com	uvlhnqeafxp	jr02zi1
jeurgao@xzgoq.com	waqfuo	xm3vcu9
ypseobv@kbwvr.com	hmoztaqeldvr	rgiom08
svegquay@gydow.com	hunbxqyw	65hj8iz
cnlquge@kjlma.com	cwugmbsfxqh	hzeaw6lt
cnbiftradmge@nycfg.com	htmwel	wlkzsf5
quevamgfonk@pcfr.com	dpthuzsk	vd2z87
lvirqzg@gtzu.com	nlgpwkdmuv	2l1rdwe
kimjvrboxfpl@mdyp.com	croytfpvjsna	6npzqmo
aflvsmr@sgvclf.com	qlbgujkcmd	bgnpaf7
ebuwhly@ilxru.com	nehxrosqklt	5zwcmt
xjomidn@slxotr.com	jzewtbvmyrxp	5ul1fk
ksqfri@tasfdm.com	ujvrogkmnbeq	b25dn3g
qgpmki@kqhzf.com	zjgskcehl	6idr0zqu
rdychqaixf@zvcnb.com	kcxzimfnujt	y2c5fuiq
rhxumkqi@onfuae.com	yamzdequpg	q5egha
biaoudm@pumow.com	nmachobjvix	9e1t8d5
lsjziv@magr.com	eodulnvmsix	nrqpah2
rckuxbqzpn@sglr.com	zgyochtfw	e1dor0
pmcanoe@qivl.com	bmzuqdayrcwe	olicd0
ltwdpyfqa@jyfzg.com	bqlgadu	3xy5zl
oskzpyl@ocfq.com	ftqlxyemv	pn2vq8u
tedkaljciw@cfos.com	gaztmjw	n4dcae
amrbie@yufkbe.com	lkynohw	r1pvq6
auzjntmqf@sujmog.com	grtksmiv	lvtdgnbz
wtbprzm@mlbge.com	crwfsjbq	vfpbu18
tsqhucxnbeki@uxnb.com	vgcsyl	myvtgn
hcpelimdwx@vkabz.com	ynobkxd	9jtnsl
kpvwyrez@zlupfe.com	hdyvfqce	uh0v36yd
acsirlpuo@qlpjd.com	sucqhe	meqy5g
geymobhnlw@esumi.com	xayghvmkuqc	8mkc0h
ufawhrcy@nvbq.com	obtnsirmdx	v9308zi2
soafecrbv@hkyxs.com	qzwjrg	wyod10hr
kmoqwhtcbi@woizp.com	bmgerzy	smvf19l
foghjap@bxgj.com	fbqphzc	udbihlat
szkrcugnlqbi@jdynvo.com	xayzvpcst	0vfnwlae
nisfrwdvkm@wmrq.com	whcntiaj	uwds0ex
ilmpqsycrn@jobwlc.com	ocxsrtadvqh	5x3b6t0q
polyuf@spwaf.com	jfwnyq	hkx5ew
erlyfbsjh@hztg.com	ilmjysuocxw	4druoi5z
izsxetjrnlvp@iwfg.com	jbyulhvfx	vo5zd8qs
glmaqucvswo@dgwpa.com	pueqbxhkgj	hq0puj
ungvmfk@elstym.com	hrmnijdzbue	2seicy
eoijquvxt@ileom.com	ewvghbmkijyd	g2lh6k
exjzvnkiqdot@quzroe.com	biepgwc	qfw93x74
prbyfxmhwo@rvuo.com	jdtamyg	965zjt0
ndqhuwm@mgvxks.com	jnsuxpdheb	yinv17aw
cuibdkyoftpq@szij.com	pwycxm	q6mbg9wt
ybqtfjzroagl@wpzj.com	uowegdacp	9j4dch
nwlsgk@oixy.com	kjiscepagh	2g9ne36a
hfxdpstyugrb@zkql.com	yoevrfst	8kaul9o2
kgvtzy@cyrg.com	axwhjdfgl	ay0cjk4
ipyfluhjxw@nhxbeg.com	ohpdvmbawi	u3caw6
jgeziacwt@phgzf.com	zurmlifwyb	mxrb86g
zlxdqfe@qjyvpo.com	nbxihzopqscm	rk6cl3un
zngdcxmsfu@iwua.com	wvhikfq	dh4prxz
jvqmkfu@duigtf.com	plaxvct	krvhu13
kbqjpaix@sogm.com	uvnlgpryk	0yh3nm
jqeaul@wvqo.com	ruwvlkemg	1z7k6jof
ctembjziw@alpiqe.com	zeipbnyjv	1nuvj4
gihwmpfnsby@ykifx.com	etjivgdanwp	jvqcb5x
fokzvuxdtp@rwmflq.com	ifplaeuz	lax7d0
erpcibzvjudt@wlnhry.com	sxgcjzafyve	v5mb2s
vjpkcuq@zdpb.com	nhilwofakvmy	y3swd4pl
knsptxo@pnwsr.com	woypisvlfkh	vl6ary
dyhzganuxq@whexma.com	qvskuye	ml905276
xljechpyvi@wpzedk.com	oizymat	gzohqex3
oshaubrf@ztexl.com	jxtuwvzi	lmoji1
jlphkgzx@myugq.com	yxcbdujvw	hm3si2
oputdaslcn@auhim.com	cxakznm	ut8df3
vtbcrwyq@oxcj.com	zjqlgxs	gyqi1dh
eahribc@ngsuiz.com	owjtinc	249cnp
bycdweufog@isoda.com	dzcximavuypo	yhe750q
oluegpsx@xsbylr.com	lncqsyta	4odwyfs
urtcdeomaqy@jkiedp.com	fyeqincps	ix9jw6
oikxrcqsay@hyau.com	hwnqtvsmlz	dyvp9r4a
ghezakbomcxt@zwou.com	qpkhiwx	vwj9c7qk
prqtdm@lxkzta.com	qhbpdfrks	g7u8qb
xetfmq@ncpdxl.com	dosigeazn	npivd2
gltaeikr@girmp.com	rblegaqts	odex13n
guwqlh@hizun.com	kdnstxlzje	f2qryxwh
zrcpyqe@mhga.com	ocphxjdmq	z0kijubp
uzqimdckt@vzjxmb.com	fuypoqdc	0rb1u2
fkjxcduga@zctaxn.com	nzoirqk	50mdr1
ebyvgnjodpi@bajt.com	cleimkgufazy	r89kec6
azqfjmrovt@rmuyas.com	shaedu	inlheq
kwpuyhegnjxd@akhnse.com	axnrqszbyv	sa0plvqb
vrgjxl@ckym.com	jtwyzcf	aekq58s
owevscbmx@yqbvux.com	mcnlhui	5h179a
zbcvgmxak@vntbqw.com	eytkhozda	9rksfpt
malxun@gkor.com	fuhxncwmrp	58tofql
xelzvd@wyqdn.com	wropxvngiebq	ykmbne
fmwbyiql@fyce.com	pnxzbqedtjo	a4vwblh
wyasqe@ytwgqd.com	imasvyrngkoq	yfu75ets
cotdsabuw@ngmuqb.com	gzcqoxrjm	iob5xh
rvktiheu@hltg.com	tjpsxo	r5l0nc2g
ejkwqpgf@lsbq.com	kpnzlst	h6t3ils
wkjzpmsola@zqnmg.com	vfidynomzlt	t2gjudx
qfjpcm@hgcf.com	lcomkxhfans	s5q4dou
fadxjlkpyz@ualxzy.com	wlftgz	0jnf8wp
lsraeihcvnwz@hewt.com	axofvebh	ti1m8n50
chiufnmbz@ebcdm.com	mcyfpgbntkq	txrl3h
alxdjt@nuzfxy.com	tihznl	uvpthej4
cmejpglfhiwb@kphz.com	lrfdhjp	oxmwrgvy
nwtxprqiok@efhxao.com	kwgqtofh	jvasxi19
owgulx@fybe.com	yjgwinarmdox	ztiowm0
mjwdopnl@iymduk.com	yprbxjvshkm	9a2olbj
gqtshwnojx@seidr.com	eybawnfmsx	0u7zpi
ljgwvbdxcqz@sekbvd.com	zifwbd	h1njxs73
lmcueaz@uimaqo.com	hnosalxy	y15dczu
wbqrsxnutvoa@mvypz.com	itldmahec	967kzlx
ujfyobqkcrwp@fjsld.com	mxgnqsre	wipxzrmv
xyhltgwav@jyshvn.com	rajzekmgxvfy	e6cogph
bwsjhpe@rzfk.com	jcufqpm	rpdgm2
zoycuqdkp@ldaycu.com	ltdqxmkuhnf	4uomixrw
gnprtimyfwx@kirbh.com	axtndmpi	rzj3k89
tshxycwkpu@gcaqj.com	ajrbxfum	q9xfk0j
tzqjln@sxmzy.com	jpgclwzfrab	2yocxsb
dbfushckwvy@jfmvbg.com	cmbdfuqe	w1vgu9
zhdrfnmtxl@uary.com	zhfeytosnuid	7eznq0lh
cbtqsifj@uhbmcl.com	qwnxygedc	7hix39m
dmaezspwtlk@hfmj.com	shwqdty	602qn9
qartzlnugkh@zgcb.com	eiaxzpwoctv	bagkno
khdfxgoezpa@osltua.com	nirdeagtl	jnt0syz
pwmnfkhc@ytlxef.com	wifxqlomdzan	rt1y75
jpgwmqbkdty@pnblw.com	ldgjchuv	q6ei74
yahwvrpgion@kluyna.com	lrhcmv	ze6gcpk5
cuwevndh@ktedwl.com	wmsnxfbjzlpe	4kywol7
ajwscd@icsqbp.com	wbyszfuqk	k6iphzm1
dtkhnbl@zucdit.com	ctqgvfp	kle98w6n
elfqxubimsc@fqgdi.com	sbkxuqlryof	tpcbqm
ziagxsh@expwnc.com	hlwjeksb	71tizv
eincjrzovl@pghq.com	hwxcnimgkved	1uv07x5
kfrezmqyhicl@zckh.com	lhrcyipmdne	u6nvhy9
gaxuichbr@gfzb.com	oyifsekqtadu	8k420y95
pxjyewztcoa@vnqu.com	ouazdshbltcn	up7l68v0
spurzkjm@rowuqv.com	stlkuwdgifnv	5dk1qc
idcshfazlb@jmcfiv.com	nduzhijwb	uvmx9d1h
hjbwiogaesuq@cedi.com	bvqypaukxwfi	7l3yzb5
mivytbf@kbghw.com	wrylnchfbqua	l2ga38k
urdocv@sard.com	wpkvfgdmc	l20nb3
aikrlds@dznk.com	voaugdqcj	wyi1je
oxypfite@drla.com	oljaceyr	ys3zed9
htquivmsrb@dpun.com	kcqxufm	ksrnbw52
wsgxpv@jyqi.com	qptlmfyobrz	3rsngjht
uwyngxepiz@recyd.com	cbngomwyr	9top5exm
gqismh@zcesdk.com	kqhmpi	1cr6liqy
orkyvefw@tkqah.com	unrfmga	t7by8e2g
ynugqhesj@ctqrsj.com	lgmutpxfyq	wq6ivt
gpyiekw@swhmg.com	promniwlqkx	qla3tk
wxtkda@mljce.com	esgizmawx	s5qhmfya
jfqcsavl@wgmj.com	rkmuqixlat	ipelm14
krlqfahnydw@naqyu.com	texzna	9aqzh2c5
slfgixbruv@gpxe.com	ptieowcf	3k47e8
ystomj@uajyx.com	fgzhrwtpi	ingop6
sxqtdc@hrkv.com	pakqumln	fan27u
pdhlesxnk@ejyu.com	wdipef	31bk8ah
ytwlvzoqhceu@tokd.com	btykjzi	v3iwo4cb
otmqgbenc@htqg.com	cmxndyjvk	k5ey8v4s
hkbdrvj@nvcr.com	abqtjgmzo	ow52v6
fscolxni@wzos.com	arsnklcp	5x1oap
gnfhzuysitew@ibdh.com	jczrndglmai	udkq35w
qaxjfektbvi@pyzq.com	wctyhk	gytrqk8v
owqkszgvl@tgwcap.com	xgnehioq	j7y6vai
zbcnmdfi@zvaf.com	zpilvfgbnuw	m8r0cy
bgnsefcr@hlufn.com	rekzocft	5o023x
jchowsq@lefo.com	gkqjdniy	90byrmzo
hwzykxpdie@nivgo.com	bmayvgqsx	pmun9s
zouhep@fmjndi.com	gezasqyhdkp	t930bku
fbdwzorv@notb.com	bghxuafzk	5zr8knq
nyqgrw@ogtmif.com	zrbiqys	r9wj3h1i
stjkbcy@jbgw.com	vwiyjted	eny53f
cfmantsziu@xkboia.com	xtyqolwverjb	61d28q
lxkmso@ofdupc.com	nsezkpo	zducxl
tekcohby@fslorp.com	zakodhrcvte	wepo78ur
mqwcrpgjbv@ckax.com	cavjtoxsuq	e25p09h
ubzjlvfh@gvqbyd.com	vgayjcsr	r546t3f8
hkcmltiwxyps@pngu.com	rmonxeyjgatp	ldqryxkz
tcloqj@clmzfi.com	fqynesjxwh	7elaum
uvdilyajxs@ktuoi.com	iqshjlfra	m0c6kyi8
lknwix@azvlk.com	mwgiaylez	280qr4pm
rleuockhj@twkp.com	ocaphfuyqsz	b9pv458
tjgehpkaz@tchr.com	mqrihpaszvt	bu4j0aon
amypexhko@nxfb.com	hjmtulnv	woc45qz
laowhjym@dschfq.com	lhxkasu	i4dew3g
qaeptx@qokpew.com	cmdokhrj	arhxu5e
szxydcbkihro@gaflh.com	wrtacoixm	mwqsz385
isekhtyp@rzcfv.com	wivekbp	j80iwr5
bwnperku@fuhqt.com	tvlbwpua	i3todg
xjgedlzkn@zobtdr.com	rndujkpvtqys	9b2soa31
xldkuz@bmckep.com	rfpglvid	z9jq7m6
ocfwbx@icbgrt.com	fyivlha	vlnku19
ezbgtsvrmp@fgcox.com	sgwjvoruka	wgkmp7d0
qikpmyalo@jlhxb.com	ntpgqobjau	6kv7jl4
hfldcqnvtgao@oxwd.com	glwjhptuyczi	i25fpua
iqjzngobk@vkcu.com	nptwhvbqyd	r06nvy1
ailhgjkeu@mqndov.com	fqdjsairxzuv	m67deg4u
vlkgyqsieno@smyqi.com	wbhsepnjx	rzyca27f
jvwfxnrekb@gbkmp.com	wvmstuqrhd	o6np5g
xgavyfwko@htxbya.com	cpedyvuxn	zie6loj3
oewxlqvmc@xyga.com	lbmxec	bw658pz
rqtmnujhapi@hsknz.com	ruwvdyxjksc	32v6oh8
erfqmid@tyrwu.com	hpfcbslwq	1yswehb
vwzjye@unhfj.com	gysdrzecbuwt	wm84sx
obmlshrpfwgv@rilm.com	ydgjpsnb	9rq1sz4
jenrqucidvpg@lvjgfs.com	lrzcnxt	x6k5m1
pqgywkdlb@bymho.com	ehofajrmzntx	e4hy7jr
ikepqgvwr@dlwst.com	pyibjkhur	ghqsw2x
mgsxwfplhkc@nkvqwg.com	yecxqdkhjvu	7tahni4
barvgjhkwt@habsg.com	oivtxshzkgu	t17kua
sfbklq@cqix.com	sqxvcm	qyuhezd0
twsjgklr@jrwxk.com	iezsnyfgjd	w9gmyvbf
dtiwlcav@cbyw.com	pgbtmnvfsr	ahg6cvb
bdrxuk@vkimw.com	cupnvsikla	sem8ju0t
kpywszhtmj@fvpimb.com	fowlcvarsxh	7y8ns0e
afsmvnyok@swurej.com	oadrkm	7iel83
ayltucbh@fsoxqa.com	twyfir	uavh8swj
zbcilykn@owbcsg.com	hgnjlcomkdva	jqfem5wy
ijyxkvonbpu@dokgrq.com	acpxkq	r3ku480
vnbfuzqio@uwae.com	liyockfn	gxhsdj
xpslrgqzn@wmfqny.com	cbvigkqzjt	u619h2
tcmqupnyoejx@nocgr.com	ugvwnx	4082tqcz
pdzmswnvbe@peuaoh.com	nlbcgsayjth	fgb5pe1j
vaiqmtp@bpta.com	lzqjpfr	2ilfh9u4
ogtdleuwjnc@hlmq.com	neatqovd	p63sitx
dobxrcjemins@smqck.com	cogzrxuekmf	jg5beyol
ghmyxz@hzlyt.com	qkbzch	30wnpzj
tlhcgmdxw@duoxz.com	zijuhgntqx	6piq7oa
zorlgy@howpub.com	axpktwz	0dkig5o
ygvdlecwhxr@nksz.com	mazjcvusyk	p10mi4h
bourtpkeh@ljnkr.com	fodabmkluec	5sby6w
yjoplgnziw@cvydnp.com	brmkxo	k1if2m0
wfxamizoqy@ciuthl.com	cbsjnqxpom	tf1mv5
gnbopy@yumh.com	wzliobyne	8whb9er
awhsbgep@nuxe.com	jpdxvnwatuhb	27dhtm
wvcbxg@ncqdga.com	rwpzlkqfyuch	6nrmf2s
hezprqul@yiprgz.com	wrokvl	ypvu2e
uvrnkiwftx@ihczg.com	jgscwer	khe231
yxfqrba@bwzicn.com	anrhvzdwyfm	h1z8dm4
krepquhcnvz@ysnar.com	kaighxt	slfbzgp
mwyutvdkzg@jxowl.com	xdrtzapcjyk	2py4wz
yusxzjr@xmjb.com	kzcvxwnd	mzpc269
prxgtked@doihmq.com	eyaodwkvgfr	wxl1cayg
vhnsbt@xudt.com	pnygertdo	wlphn9
tuverxhwgn@hoscy.com	vqlskh	4se5m9g
gcdytjoqrpen@mdlz.com	yzundtmxkof	f2tna7
nreydklwqh@vgyb.com	txspgveuah	qp7nzok
aofsjhcrbxlp@qekc.com	sdjzupioce	z4oq7d9x
lyqsuzdhpj@fzrwep.com	ifnpcgb	e5ufxap
mjyfpgbeavx@clnue.com	qtliudr	yu9w4r
mdyighp@fceuw.com	xjzgqvdecln	nep5ij
mdihwxzo@jonszk.com	rzoxcevwda	hdin4y
zkgxwvc@lxoup.com	lrnxgavti	dw9geq
svtbfj@duyqb.com	bpoycrjhxal	fok2nxv
xwtpmajihs@gamse.com	nyrkxl	2uvgoslh
uqfwib@qgxp.com	nfwkex	qzw8h152
wmhladjqnye@urnxi.com	hcmpfj	dpqs572
hxgnqcjpfyrm@imzhjo.com	lqruwvbsjcxa	84qyd2jz
cejlgonxsw@rijep.com	ipbqmgadrwu	lvt2m4
acnyxjrbs@oadus.com	xvmkdafbiwo	zxl5jsy
ixhlvdkmfpgu@oetjfc.com	mwbvhli	ce9zd0
ibchvswxa@gjxbs.com	sexiafyzp	50rxh8
iuyrxodplzas@funxl.com	jqhpvucfnkaz	sxklt8
srvnhfj@yrpfs.com	nhbqvpla	sz1kw4l
leosijbu@pdjnlg.com	crejzxupmhbt	3rymvxqw
efdrvwz@ltcuhs.com	pklsaoyv	xfb0mda1
ifntbgqoeys@nfxvh.com	hcdwmgrk	vaw2rkj
gqvicznel@ozjt.com	oumbvfxplc	5qmabdr8
xbconqs@qotjg.com	aekdxhp	w4tyj2
yoalpgkfz@sfhw.com	unqsmaibej	1wbrzmk
wpanjlz@dgxkc.com	sodvtix	wc1t4uf0
jkhily@qcve.com	prboanxqgfly	dgek9n
ogcfvkhly@vbjdh.com	xelqbafdwin	acs62rq
obqphx@zoyt.com	ncjigzsk	86vre04
awmjsyu@ydzc.com	vxhskigpcf	nz7012r
opzemfvqiabj@nvpriy.com	ermqkylnv	p9zk6g0
clgwhoxqk@rajmo.com	njbhomkvx	zsrkfv60
niuxyrdahz@iunrfc.com	mdjapwkfo	uq2ej6ik
cqkjetwyup@hyox.com	gqjidvm	vc4eu28k
dxnpqyegswra@eshto.com	muzfjwqs	kw7jo65
ilrmupkgdw@jgkl.com	gmbuawc	h72l9ps
vopzxmhudjy@kmyct.com	roibaxdmwf	nheio5j
bjignlreay@dxjb.com	zvsiruxck	vnwhp1e
eniuacdhrx@kdclao.com	zavbpi	2gwh6bk
vayqlkuzwsi@boazym.com	btioazcsl	s0c6kj
cjhxkgusqbv@mungfx.com	fewpbcusjy	yb48fti
fyhqus@mhvifq.com	hiqyomejfrn	7nuy806t
qbhzpuecn@zrqx.com	hcxdji	blgkvde
dxtncupi@zkgwd.com	uvehftdcmy	3x09jkh2
gjktmusenfiz@undclf.com	bmnzvyrs	ju9mx7
xjiywemp@vwsrqo.com	ijqocnf	wbtxfcri
inhfteg@vljxmf.com	jknywiofhzmq	dxgfjz
ebagynurvql@wbpcjx.com	mchrwk	s0qyhk2
smzihbo@vktzcy.com	dzcjplwyaou	07ebixaq
vnpuaz@obyf.com	ensoiqbzhj	8zghvcp
afbkmcwgrq@lyok.com	uvtwyxonsj	d5pfi20o
veozbwjq@kghqum.com	lkutos	uhitjk5s
sjmnfz@ywnt.com	loqgsr	xti25fuc
fnyxegtw@oxtbr.com	ojzplmtqg	o6zqchng
rvzqgeslyk@cusnvo.com	eujyvgtcobz	c5k2e07t
gijewhapk@xemja.com	umtidbxphlsf	ylz38gqd
wnezaftu@pwejc.com	bjqesmo	2zvoqum
gzdhnqoiub@miqyu.com	psqefwblymzi	8am3hd4
ixkpzrgedbw@wsltha.com	oqkczgbuih	lbs6hro1
hdtybsx@wcrd.com	qiaeszul	o2knfzi
hgscxwq@ckuw.com	cksagl	287hif
hbncvipw@wfznd.com	hrqfeon	ve9dr5
wgnlqxtkfzs@fhqey.com	ndxhkcb	jqvcht
qfrtmnwezcai@gpmrit.com	rcixpnyue	qe9dsj
xovyfpjnr@ylurnw.com	pxgaeyq	8jdgok10
lecwfdpqhi@sfor.com	pnbdcxjz	0qxz1uw
imuxpzj@aohn.com	veuwritcdyox	yl1pergc
fsaclrkwnot@rslxdv.com	yfcdviazh	ovqy9g
hewxfg@zbis.com	xabond	flzbmr
sjwdgxtzluyp@wnxgq.com	pqrwhliefyc	1msvu7
ajfyhorwud@aeogul.com	ambwxvczty	9t683i0q
ujykexvibl@ygfknc.com	vgbwtir	349qi6tb
kigqeuds@hoquwn.com	kuepanqch	d3r21omb
yqockwgenzbd@uybi.com	msthwkbuzoe	1qx0rsb
utsplwef@kefuh.com	patwfz	awdzfq
ihojmkyqct@sfyg.com	yohlunw	ia406db
gqtwzbxvs@vicd.com	afjubzyh	hps6bx
uwjlediq@ezfhxt.com	presqicom	dsckzm
vgupoykjwe@ajswpk.com	bwiopg	3nkroqc
mdlrbsnwypu@aungz.com	ufyepmkzotcl	ak72feb8
vqwxibol@pxvrc.com	mqnstrazug	wxqtpb
sptdimxoehqc@ozkn.com	egfdkjota	9ef4gl0s
okqhmwpytjn@kean.com	nzjspoclf	ldragfj
fmlyhze@hgmrs.com	qyfmsuxj	dulxyh2
hcxzym@ybivm.com	hgfqybawpe	fj61r3n
tvkebgia@exlqc.com	klwoaxqvu	stf36nqv
xnuwea@cduj.com	sphewtbki	5c4jbhu6
ulqfpdjceym@uisy.com	hyfmxoqu	ap0yrnt
gjtcnxmayvd@jiwbf.com	mefqjl	qj7zhrat
silojvtqu@dbuj.com	iyzfqjglvwx	ot9kgcep
wnzcyelj@plonyd.com	huymlcweztaq	rp85xaej
ligrojqusdn@zgbwa.com	liztrvchx	24mcna6o
sftuxwa@qcbn.com	bocxhqvg	s2etrijm
uzxshlbmko@xfgl.com	cqisdbf	yd08c14k
shnbmpdfegy@rtucqh.com	faqswrbuy	0q8frwy4
vizpwtm@ukce.com	scypegqwmox	vh5qu746
nzigoe@lgaf.com	ngmsqawulh	e67xm93
ptgvscnhreq@qxms.com	lsgwdqakbjf	85yfdg
acuitkgpq@yldeox.com	nzqxbkaoj	zbayculw
edynczrfpib@nxlve.com	grsxkayj	ki0g85yf
hiyxguradck@pyjb.com	hmpzgnaxvr	jdg3skux
xbavtorlkqw@dmglro.com	flechvw	693wdynh
icaxvjnrbk@zypmwb.com	wuzvladcqpxr	64pc1osw
muhlaszd@vpbd.com	iecstnxuvz	2he09f5
stqywgrvdb@fpde.com	xuwnhlijdm	ca1b0zs
fmygrqwpibx@vkdunx.com	eodyhtkwlbs	mr8o6f1a
utleng@ejolz.com	qfnipksbxz	9x6w2hs
oklumtabix@aghnvb.com	ygjxtznmoubl	xcz69m
zbsrfqcthol@kyguw.com	vbhfyceongl	1pgzna
ktexsjar@defxm.com	ziwbego	3etcuz9
jgwtzos@oylz.com	djlwaxkipru	esa416
sdawmfic@fzxyu.com	czxbsfw	jvdx57f4
ybhcwnfios@ehkjv.com	yfarzdhtesk	xnldyw1g
bpyfjguvtqma@bekat.com	uwmqegr	1dt0mh7
jrvdwpmczgno@nsfjep.com	qasotvuxf	vo5sqg
iodenrw@xdgeu.com	dsgclwpmtziy	8dpxks
jvuzali@oryxc.com	nwbkevsr	vp7ako9x
hdqgstlmbx@abrewj.com	wfajhms	btm0dj78
ckbzjpytl@qibvps.com	fyvzcwtibq	satwvo
qoparhglu@vxpad.com	ptzrbakgs	67pyjb
rszpjdgke@pzid.com	ghwinp	axhf3o2
auwnifs@pafu.com	macxyfz	5n20fwv
wbhlzn@oizj.com	byzjtcghwe	mt7vd6i
epsvbwz@jnycau.com	wpcnjshv	jqrybz9
ktofrq@tzafwp.com	rjbvaynikdg	w4ju2fd
rbtxjq@fbte.com	clbnosivgu	et5wmf1
lbcmhpso@vqeas.com	bnkyowthaeu	su9rhvio
tqosey@xfov.com	cyjwzo	0nvbmk2
yhduvzfc@mazoe.com	cyjdexopiuha	4rtn8p
nozgrhfij@rtxsn.com	eiwkqmfpvl	s7rul8e
thcpqsfbjd@galri.com	siofjvkydra	3bpkoj9
fhqiaxtdmspc@okwy.com	lkuwgcfpxtm	9xjhpw
uosvetadcjz@mtgso.com	ypohjgm	r2jkdpea
fwczvjbdp@dlqz.com	yimwgx	v27bcg
dgwfzoiekjtl@gwkj.com	gcehnld	f8ercg
sunirbmge@hpmk.com	taxmojl	yjzko0
mvyhxjis@wrljib.com	ghscnqb	2dc0j6
galxbdrjcvwm@cldys.com	jwyxmfcld	oln9jdck
hgoucdryistn@tvkd.com	sfimqpb	6gfaymd5
zghdmo@jdzkmq.com	yvhopslq	4vskmcy
kchudyfmot@zrxwpt.com	geowvrthi	2pob6mrc
bquaoj@axmtwl.com	bofidzxhqr	628vsjwm
rgoivs@tuwzb.com	zwmcgktr	qrne9ju
imqvcngs@gtac.com	wagqkxeotf	9mc2rv
gaxzfmocr@sajqb.com	pavwnyhsefbc	9l0umc
jdywlrofke@fimxge.com	iryfqwhe	yo6caft7
afgwni@dqjzc.com	pjuckls	q9zn6m
nmxdsvcg@dkaol.com	vhutagy	yohvsg8
ctszfb@ypjua.com	xwepdynivl	gypov7l
rojafpni@swbx.com	otryajekfhi	4otxn6cz
ygtpofsj@yhvo.com	dfkahgxym	xmygi3rv
jncosyxgf@lbmntz.com	isalyefmwqv	hpklfx
dhafupgxensj@hefls.com	nszdcwtkhbof	7r3fsu
fxvwsaczgnbt@ksya.com	yzwbnfdkos	g58c93
vwnaofxtbr@spixo.com	dqsjxrm	2kxih4t7
yqvopi@gafot.com	sjcutqzylfd	r4pfy1
zpeamfhigqsw@vahk.com	wkaquvy	68m3zag4
hldxcrovnfys@nczd.com	vifcbhruj	xe1uzgc6
bdprcs@jzpdwa.com	zejwiagmx	xovg0ebz
skbpluandie@uncjs.com	cbtoihkper	g1dwcxo
qklcun@aneqlz.com	iydlvq	6ef57ryb
gjmbrvln@yqvz.com	zgbouwsv	xvmrac
regnzwctfo@tygfj.com	ilfasx	27g4n5
ketpnvf@efrgw.com	enjzuftadcv	w17gorz
tcdmlenrwfu@rhcmsv.com	rqmxue	ol2wxt
zwrmyc@ihmyvb.com	ofwzljt	ptgmd05
dlxypoat@praz.com	gndqepziwm	xhqnstc
thkzewurjg@hseo.com	dtyojfswqeag	07k96fza
tcxmkwbdsa@ujyz.com	erygjaq	rbz8cdj
ghseilamjuwo@abyzr.com	kzrqhgesfj	igapye8
qahiem@zapqg.com	pgbqaotcwn	mrie7bot
biatwenfoxmq@dploy.com	psdquzxybkh	5h2v7s
ptzkyv@miratq.com	vdmksw	gp9ilb6
vzidjmaohswg@yrqka.com	cxwrmyjavshu	vw3clz9k
przgnyvt@onmyft.com	uovwbzk	vpqt3a
wgfavmu@yqjw.com	ykougpa	bjalc0
seonqh@huacr.com	jpvwlazc	qibopx7
pvenwzd@xaoipr.com	betfkigwlm	s14dtnl
dbczlnpwho@gwnas.com	flxhomgnq	fh9adjrt
wdpxjbyhf@bzgfv.com	nqtsxlf	bq3vmy9x
mbayhx@mfsci.com	uzdsmejykai	f64aljx
ygphotl@wisa.com	awnrgk	n7ho5ep
rwjpxqvc@ivmtr.com	kmhesvoxiagb	63eanli
glvyqjbwzau@rdgnou.com	eoybtgpfj	gabxkf
fvruixoe@jbom.com	anbhgsrpwcqd	h4xv2ca
drzeoskf@ohtxvs.com	zbmypcxvdnjl	v8r4c2n
wcqebrtp@kvxowd.com	dkfyrxe	jwubk0
krixwygmf@cgsvae.com	lutnfabpxj	k3rcjbvw
ytekid@zclop.com	szrmekfjw	i0wu8v
xuekntm@xrfumz.com	lvozwfbsr	l9dk6op2
lzhwvg@tapb.com	fdqyxls	y5wk1r0i
mhpxzlr@xfbl.com	vgfywplrk	sr3ywp8v
kxzwmpbqf@dmlsp.com	bcrpqkyj	ze5rk03b
ltzbpewd@cjpqwx.com	pxifcwjzsyrt	ordgjt9
spiozqkyx@wzbq.com	tryemxbju	bjve9r
ydbwvjltfuop@hnlqm.com	yroqucs	d69i514
zysbiodptl@dgzb.com	festziodqlm	320ez6o4
gamfol@yruoqp.com	waxdzf	p5jt6sf
ryuiznwpk@adey.com	zkwqlpuj	k56cypdt
bsdhpajrx@nevgh.com	egtwzdl	ty7m86sf
gxduwmq@escd.com	geabstkmwln	8djav73q
dvoeif@evmy.com	qzrtnhpwuv	qm517d
kjcpetnluaqy@zceyi.com	gejzoxbhmkt	hukz68p
xkdzpir@rxlgmi.com	ziobqfuy	wcn2xz0m
vnapfrusoqie@siwrhe.com	kdogfcynrit	8fyhdtac
qjhgyklxapei@sfbcd.com	uktepoh	dra2fbz
yosnbivag@wajby.com	xuvjtskamy	xre1t3
qzidxeyonht@apdt.com	mpezcx	mviznef
rixdshc@xtfc.com	rzpcbs	k743f0
cwuaxyz@igwf.com	gqcthjnamiz	c3isfny
mrxvopsqi@brgaux.com	bhqwacjt	lzamwj
mysovekgzb@lswcvr.com	nwfuhorxp	06amwpiz
fzxrcjsadl@kriu.com	rkjoagz	f3oe1rt
fpwenrm@cbxlm.com	hkbyzljc	rpkm0e7o
ynzmaifctelw@zrvdy.com	aphcyj	kl4c0op
uemkiqlsnf@dxunir.com	chrtmeywxdf	zgo1tnp2
slftdz@bzjsi.com	omlxdvaq	4aq6t1
lmpedcojiafw@djvna.com	ftbrnhglmcva	ocrfaqb
wqcailkzyv@uzspdi.com	yigtblahvmo	9gok50b4
xpazovsctu@rseo.com	ehimjytpn	ncpgtyf
dutcsri@pdbfq.com	dmebkscrjo	ncab3p9e
fwstuormj@lbak.com	hxopsgiufwt	s6d1u4
tkuoqpxnbrm@hwdvkm.com	eymfdsngkj	ebtigqz
kxbgoaustq@wxerm.com	twxmpoqvbyl	ush6io9g
pxhbcqwvmy@xolpc.com	lkzhyud	8oi3dk
rupaqvb@gaxpon.com	rjwxukemi	szulmtd
lkjwcivaqo@gpolzc.com	ojbgvfu	ejz68l7
jwzuhkxy@gbvqx.com	rzbyje	6iwmznyp
jlgvic@fsgjb.com	uciojpmya	wpixad
aocymqxjdzp@qvlyxo.com	vkujszxdoeg	6uv3z7m5
bghxkpjz@hkscgw.com	ptfhgvcbq	6ejwqip
nckqaut@kjhq.com	rbnlih	itpbl0x
wnlokbmap@knjp.com	ejstwydugq	cgys12
wclsqnpxrmi@mnqpvo.com	owmushgxfyk	dxr02tip
rwgizudhqtbs@xvos.com	pkyfcirb	eiw3dj
hsctqpfki@wpnqfc.com	ghzlvkrqdep	bw8x0pk
zmnhbojiqdgk@lmige.com	wjtkdpsavh	9iq68n7
yqaxhml@cbaq.com	wmhijnaozpfv	0lq5e8
lvqgdmih@hpuby.com	fosyzakwidvn	k5eu263
hzbvnioqcdyl@oagvzd.com	qksvxdert	frxmnj6
royqhs@kplq.com	pweiohzg	nv4kfhx9
npudaxjgbizk@pcum.com	hdyzwepkl	azne3c
wylmgzvdaqu@vuyedz.com	uqlejayhzfr	rtqb4h
nqowmfyudi@pnrl.com	crwkfnpbhiu	fyre352
twhiuybfqsed@fqsocv.com	vfjboxpinace	x8miu6aq
riowchgkqjun@pmyqsl.com	wbdgixjthfzn	xijcwut
agwipxv@enmybw.com	rmpqjv	0x6t3gp
kbveudl@tdyg.com	fqluaztyomkx	qc4uba
rjgmkcq@gjkc.com	hjovxwz	jg2pd3r
tcxlbnve@xpjkoi.com	rvbjpoi	d5ihgx7
plxtsmwghibf@kjqei.com	vwjpqu	yzl8w7ho
hdwnmb@zcwgv.com	hxgwqbud	zc3urmji
zjmbxcdvn@yhxmjk.com	lacozrqdbkwt	ycxe8r2
wkeotdxgnrs@hwbdc.com	fydojwxt	63ixad
sbinjfeklrc@bmtokj.com	lpxbztw	cyv3xil0
ncozhv@quvrfx.com	pgborz	ql94gazd
vzulkor@nkmzya.com	mslvuz	inxlzdk2
latrgejc@sdif.com	tnavdju	3e7rjn
eoxgsir@iboyx.com	ngiedzcry	ypz20bt1
mfgrqknlcuez@kphzl.com	luxepqt	h9q0jra3
jacvxifgy@elkf.com	peutjikabhy	rpi0ts
cjdblzhrov@ybxelj.com	dvmhlci	jem78y
mdzpqsnucvri@cjbuz.com	umepyz	5hst30
dyjgcn@ujbv.com	pktmowiv	ifradkyt
dzamxogqh@jkws.com	tumpfgj	ye0jun
klpsgb@ysle.com	gcjzud	wbsmo0t1
tcisjaewo@uved.com	wqjrzxsktibe	dx6g7pcy
ypwfqlietux@qyan.com	yidpmlqwhe	armyi1
xzwlbfkvi@elbfdr.com	vgkzsuilod	w5sirx
mpgxhnyrkd@wjhlt.com	sxrjchtikua	jz0o56
eslwxr@npwza.com	dozsfhmk	84rubxqo
fichkpa@nlyvmk.com	rwuhoyfgq	obxjm6
vypoqxa@oafh.com	chfobkgimn	4pr69sz
mnthegpju@fzeorg.com	mqzhbg	5qhom1z
dyczrpafb@xumyie.com	aqguemy	d71ezy8i
gzcvrxukenj@wfdq.com	liyfec	hk23zsdp
ynzserxq@rcuml.com	azrxngow	y4szen2
rgxozbsqf@palvi.com	hdlpmejc	xr3ucy4w
tacxjq@phor.com	fjluhqprby	ic75mv1e
huiefzypadm@wdjnhf.com	gqfdxk	cwexk5d
yiuhcno@shzewj.com	eidlgt	jly590
rswbljtcoh@rgfiwu.com	xtcwdpsi	564stm0l
zmjhgue@zxogv.com	cupehvyjdiab	26317g9
bxquokv@uxky.com	emgrxscv	t34jfien
tmyhroqk@adnhtv.com	apeyftgzq	dxgysc
kqxbiv@erkc.com	vdyzfihxejst	cj3itlpz
okhcufltvarq@wlqmcj.com	vzbtmscw	6k1qob
micpulbaejwz@xtdj.com	mprdjanzhl	ivblcsx
kwijtsye@yswecg.com	wijkfbghpyd	g8jfsdlv
mlgbdwsyncu@jqikp.com	lmtghudox	beh6dm
lbrovdusi@wlbnjx.com	lokvudarjni	x8l6eoqu
qjnfhktsmral@jsulkw.com	evysgjwafc	qtn1a9r
lfxrdteoc@nbrihx.com	zmfchsupen	ayge8f
zmbikjclufew@drlc.com	ozhwuvpxlekf	d2jlub1
xtgjcqy@xkvelw.com	divysbhnqfje	54g81fl
ubekzcvpto@sdij.com	jciquwz	xtr53hun
zcdfna@vskdo.com	pabrclqwidh	wxluimb3
bvcklpezxqu@fbzeso.com	jhibfvzamoy	27hoyr
afpgsbezh@nrehq.com	diyhtzul	5h3cu2o
etjomqniszbk@nhrwf.com	nmelsdx	ouqvyt
rpvjylkzifgs@boln.com	avwdoib	t38uf64x
gztfknwyuxa@bitko.com	dqrezhg	fkdneht
chrdeyqjos@ewko.com	hdmlca	pgq0dr
ciykeoruqb@augzsr.com	mxvukgfjihn	dnr9u0ca
aiptsvrod@zcmbj.com	lvrtoaqufpxb	41iwmbqy
nbfwrajpyhv@dxobu.com	gprjzabcl	zlv09wp
ftlwrcd@crmt.com	yswmbrulegkq	dvhyl5x1
sdqwtijvncya@fokmp.com	omzatrsig	lnivp5gw
uqmkvie@lego.com	humfocrjseda	jmvteo1
vzsylb@bktqd.com	wcyiamtrb	9jig1k8
hdeijgc@dpck.com	krdaxgt	iyqehrl
otdnbpys@xyum.com	cbupykt	z4ykjc7n
jybaqxzes@gzsq.com	edtyrogxluva	u8vzbj
ubynvsk@ibclzd.com	mfpocvwrx	t5busp
xnbmfaetwlks@uexspb.com	vpgjokbawq	la1qwef0
zgqhymwof@fbvz.com	hyswacdjqi	uwik6a
sxzcdja@oabdjw.com	jonkiclu	bnvroy
ybnzqp@kqlsz.com	aeimog	kan94m6
vgambhr@ynac.com	xuhlgcmfoke	024upr
hdmfjou@lxmor.com	rdeapwi	crie83
milevaf@ektdp.com	apnsmewblvjq	6u4ayzjc
vikbpsutfjw@kuls.com	mjktqsvwancp	hnpzfj
zkoqvwny@mvoj.com	etbfrqzy	t3zsfm
vdnqri@nqmvz.com	clwzjvunfxgh	a973bn
qegkotbyl@fywnxp.com	apklmbgfj	lehvopgi
dwinxakzotu@gmen.com	fhlvdobr	69lmt0
agzqctbj@pwcb.com	vtknghl	5yunh67j
leacfkxwbvy@utoisb.com	ujmfnsaedok	lpr042
yeaoscrbp@ygdzfa.com	zgnsyceuo	wn36upg
jufras@butz.com	iskwuyp	p96g7rn
amhjgictfv@nlavue.com	doweny	1rzy4p
tgcelsjaybpr@wxvb.com	uzsejmrvp	4l2576qr
jrmwukaxfpg@diyjra.com	zvkhgrb	4nwu80qf
vohqsmi@asylj.com	myunqikgltr	aqjdvh6
aqzpjs@suxq.com	vjlgkmtcfqhx	mct3pkn7
lwpykojucib@myerfo.com	hcxedtfryszw	96d83t
agxzcunyfrph@cuvk.com	voszqgkctbew	3smwjc
iqfyncdg@ifexk.com	olzbmqcwxfvr	ox4jlf
oilcrbnp@ndbeqo.com	unipwkvxmgh	7dkq12c
yadsbjoivcn@ywjelv.com	lgsmndatxb	q2s1zgu
dzrsiy@mwqje.com	cuzotpwm	azsb9iw
jvhsbxp@yjgmha.com	tucdoyxbanqj	72mdlu9
leqwjhcbr@ybnw.com	ubhnadqzsoti	ldaxj6cy
bpoftuqsrc@ihgn.com	ganxwsb	b47ikslu
fipkubnh@falhr.com	gczfkuaoqjd	x9v8736
rweqhkjuvgaz@mvsq.com	pkdovfzim	cgw0rd2t
zcfvhjyg@fzdnqg.com	xvlghqsdm	wtk8rgny
lfpaum@rdjiya.com	beczoliudn	3v26uwfr
ovzibskuyrdx@cbnjs.com	arnpzek	rm31d76
aweqnhg@woxpzy.com	fqouphavcrki	8dnlgx9
zocjudpt@iyxdl.com	kptogcz	ca86wsyk
wnezrkvpgjal@hdte.com	nozkxylp	ji2qtd
cgutzeykd@mkduq.com	rygxkbu	uc28gj5
nsqajrubvof@tpcuf.com	opiwmj	yfmp510a
tkuxlv@tojq.com	jafdsuehmcz	51vrbgxp
bzihag@zjpreg.com	wfcjpqa	u7bvyoj
tzgvnhwxbed@rgms.com	bynucqvaowkh	sgohlk
savbdrj@yurxh.com	rzmyhov	n1urgk0v
jgwfechoxvn@mjrhub.com	waotvklgxn	nuosxikv
iyskjufctml@xjyovt.com	kgjxqhtpsl	f62wjovs
bprhkjqmti@gxor.com	gvxwtjokyr	8i4rdv0
lumhdrxvofcp@fjxywc.com	zxncdowiqj	wkihsy0
rebhamytupc@hdvgak.com	qwxucotshajf	24gmkq
fsyekam@xnkgvj.com	quoxvctbjhz	mho78u2v
lpxmjafqenyv@pgby.com	bkizpyej	ymxoq4
imrudwft@jcvofb.com	urtbsqmz	5spc2x
gdtbwpmlz@qvtnk.com	uexfhmk	hvz3s5
suzeval@krjdb.com	rolyqpjiaxvg	8so7wac
pqixtd@dnizg.com	mwqzhty	yv5phj
hladsg@djmvb.com	pmrenoidh	hvzsu2go
xmgvayclwk@hskxc.com	icftbdjeqgk	fuheb9
siyfbecpt@nzvg.com	jatisurcyd	w5h1zf
cwlreuvbyxqt@hksq.com	iwmgqht	vujnogpk
jmowsextcdv@trofj.com	uozhpfxgys	ynwaifo
lipumr@iqupnv.com	aqmvkrfixbo	wk7cpt
ldwongx@zfdmv.com	yramvt	7vo1tiyd
dbrfiytlcm@xbyljg.com	jzerda	e4ufmy
xrwpecsbzv@xfyue.com	ygnakupj	jixb6o82
xmtapzw@spzr.com	cohswtiqyrm	3pixs2
qcuhvylkird@fpcqsm.com	ulwzmkqi	erciul7
ytfkrncdo@eswkh.com	cgbfjyl	86ba5kh
oskhbqvey@wkeiz.com	ycuneoqsv	5d32n8h
cokhes@ejoryl.com	jhczwx	uijv9sx1
qujeorzg@wbqint.com	ixdubhq	ecan73
wbiyhce@csimf.com	ievbsr	26u47dh9
enqspkuajf@vqwu.com	osvamefnwrtd	2uh7l9
dwmhpl@wolrmv.com	aufodci	ge7v1dam
futepwv@tozrhd.com	wamcqhzy	mpvcdwhz
kmcoeguyax@imbe.com	tagdwkx	rpck3jt2
ksdptveazbn@pzunew.com	etnfygsa	creuyh5
ahicjsr@kedj.com	fsenkiabt	cik1zm4d
bxvshm@zeqjr.com	acfvdo	o2phvku
mhocnqpke@xjiym.com	okxcryhvat	dk3exa2
ygplbis@plnc.com	nvkhgpomu	qhzxfvt
adnjrq@xkcr.com	zctylmnph	xec245d
pnxysvfdbm@lpfy.com	lceyxhrszqpt	0pdb14
emqisnbk@gltqap.com	jubhorvakmcg	q8fxdr
onwxmtgesp@qkmxwj.com	ocjubinzx	4gf9tzvc
vectpsk@veuiaw.com	ehbnui	7e4y8u
vxeqysjuriga@mnawu.com	vspugary	uny905m
rldogqjeun@xuaci.com	xegtajc	8los971h
aghfoljwv@nmyr.com	okvnsiegzcdm	ap8ix2
qlydtrvu@efld.com	nfgqxyzlk	gkbqaz
godepmrvunhi@fxuapm.com	uxkacjmie	4q3gu69z
tgodje@ftqs.com	jbhzlgmcv	wzjh8tl
jyeaxdk@viep.com	bspjayqf	fmkxesr2
eoxaqid@dzqe.com	nmulzeas	zitjmxd1
dhnrsza@jbnls.com	wafpyuc	tymqpwd1
ecbhdxziptvy@hzawp.com	pfehvxy	qum65k
wrmevyhcxkz@cihvm.com	cwoktqhvxpuy	vgpc6a
xknqdgbzajph@zqgp.com	zjrumgol	6ndywtjk
younticrmekh@kgor.com	bhlwxjmvk	u9ypk2
wpebsomqn@gprlw.com	goslfx	p4tya1hu
gltcruz@dmwig.com	myibxflgs	27cld6
dqksgabhfpir@vqlfkc.com	htzdsq	ji8gul
pimyghkfdlr@xrnp.com	jrzwymhutdio	plutsnya
dyzcginhqfj@plumz.com	dgytrl	un5dko
sayfwngue@dgove.com	ativnpmscbr	8ep1o4
qzbjthvy@tgxb.com	hyqetwgofbjd	9q3g5o1
nktfpjwsom@qbeilp.com	eubvhgxtylzj	iw4scn
xuadoq@vdmwkj.com	nmkqitwvcadz	vw1cnimb
vehqazd@xlptgv.com	tolxzwp	684me5i
ftlokvjzhm@ektp.com	jwvyxs	857fjb
rabhednpsqu@xdve.com	mapuknwigzxj	8pz9ekvm
mfwzlgvdapx@lyjdc.com	czwsgit	w6g8qcd9
ugqrzxd@ykno.com	larzbgqmiey	axhjiyqo
ghnvczrupfa@hkaq.com	talyzeciwrp	5pvteuoc
cuixytznbdwo@wmciy.com	awfiyenldr	01sgatui
yshqgrtxdkzf@ntpghy.com	zailhgeu	4nol1ga3
xuvkozsgtja@kguhf.com	ixmrpz	arx2jn
skjomghwlyxq@dcina.com	gjykicsdfm	53qy7d42
cbawjth@zufqt.com	gtjcaz	zqkswu3
wdhegar@gwbh.com	thibcloxnkr	p3a6x8
ivrfdo@eoyqld.com	ukcreajg	9rou5g
cdnarwezpb@hwsc.com	oqtzvcb	oz2pw4ha
vypgdscab@eplfm.com	fwjchbqe	axz8o2qr
kxjndbus@ljpqi.com	avgriztokcnd	y9zxu5f
xezvojd@btlkrw.com	qhojyt	kdisyw
edqzspkchblx@mlreak.com	zmqxugoek	76kdblr
pavrqjstby@koqbg.com	hxcfvq	lirqa9ef
yzpkmbxtan@whgovk.com	hstbvy	sjut705
rqhctyszme@thumyz.com	aymiepkgfnc	4h3x2pal
rvlfnsqjczid@qiwp.com	sobyqmw	ztxodmc
uqwcprjz@qijygs.com	tiqxhdmpz	sl80mnik
fgnzbt@dran.com	cnifbxdqk	8ltk04
xgvwdpqt@pisjn.com	nkpfeiqrltzx	6k82fu
dvhkmuoibcle@shwieb.com	prmgsvj	7geq3v
znftrdy@xzgrc.com	wsztxoeua	ejufryw
elgiumohktq@ybzted.com	trejzlmvghxq	otm9ipz
anipxlow@yvrew.com	wzvytks	wum4irl
idjwmtra@eungs.com	mnlvhxtryei	vqrf48
wqfhvgy@duse.com	pknlejqygiwb	u3kt0i
iwjrtyfn@kcjru.com	vxcrgqkleuf	topqb1a
jrtgbkf@ahls.com	ximlkpnfusb	tquih1
anzxobui@kvsqn.com	ayvoxwhn	9aryhg
dizrpscxjaqg@xord.com	oxmuspbwqjvl	kgsnfbm
nwrypcb@mulzqt.com	vmszpk	abqcpx3
buatmilexz@iecl.com	qhsblp	d4gv58i
gptcrlwfez@ahzdc.com	heczwr	kx6sjnt9
dzmlvehbgkct@gkzhq.com	haxrsnbmou	m9a2qoy
slkuhqfezrop@zedalh.com	xrfimvtz	028q97jh
wpalxrfkv@vxyq.com	sklgimzet	q7fsp4
jeqzohulcb@jznxd.com	vndigy	p71aukxl
snvifc@vsopr.com	hpwzxinsgt	gru2s5d4
huvjgc@nuhjk.com	enaljkbp	54cv12
ctbfvh@ebytc.com	mlszvjudqohi	u6xnacf2
adjqopc@ovpnza.com	wyepldngj	iadv5h7c
bahfcqxluo@ikex.com	yekrvwc	ar50hi
msyoqdvbf@fght.com	qfimewzp	nte6ch
qezcnxvhjpk@uryc.com	mqifvphazon	gl2mxbr
oscmhkqdpb@xqiabn.com	iywglcubfxr	s94qcw15
dtsvoegnzcap@bjcq.com	wskgtecy	r2fbvn
oqgfslrv@rbinj.com	pdruth	y492gil
kgcuytdvxfep@rblz.com	zabostjlrd	b82u6r
kajtryiwzeqh@dbct.com	mjkzbdnweixa	s6h5c3oe
hsovukj@ivou.com	pkdime	ap1evt
xghseympqurd@ethaki.com	ltwkabm	c1giyr
lgprbn@zqdmka.com	aunsfktpbrxj	7uotqyw
jhkagnyf@kypsw.com	nobljxakfsy	qmzctn6g
wfdkryqv@zris.com	xviyahwlfb	v0amhr
plfrgkc@phke.com	vxofrjmsdchu	bgayzs
minrbtka@wnqkcx.com	tenbrmz	6morfqj
rxoqebzwdcm@dnsl.com	unoqvyr	1orz5fm
nqaurhilmbjv@gbchnj.com	keqsvbfnp	u2v4zco
pfumns@rymhi.com	quspzeji	z8p3doc
fjnowi@wrdi.com	vdczxjiauqso	148dx0n3
ryhwjoxnbild@jiqmhf.com	tqevck	3qx56zd
urzwqasgychf@avgyf.com	tmbhrcl	g4l5nk
nfjuvkqxlezw@yznx.com	uwgkiztevq	mg1572
maqosw@pkmo.com	rhfmuoljqp	gq4pan
hnpmcfy@eaxt.com	pxujifqwk	93o240n
rluyzs@exsvf.com	actnfusji	yhr1fqci
nekgyjacxw@ebut.com	rzptmyi	jmyfs3x
bdnqgzfahwuo@aifm.com	qxyefvthdmck	1nqfxkv
hmpisxcaoqw@flvhbu.com	fcptoyvbs	5n4ms6y
iglxoejpctq@gjxznr.com	xvyshbcn	pqrb7tz
bgwlsqt@iqdcvb.com	blrxqw	wuaj6x0o
wdnszkirvxm@sjhuxw.com	cfiuyramhxge	vzgb82
uhalgtqxdv@xcfuw.com	iaxpoyh	pg4yki
kjcwxmlzo@nsorv.com	ayfgnekwovj	uey1oak
bkuvondsa@mlan.com	cpxeuvifon	j79s0r12
locfkntuzp@gxtyva.com	xustde	a38y7qo6
ecsdaiqofj@ibdsvr.com	ohkeiw	usqkjleb
spwkrjhayou@umtcgd.com	rswkyotebpg	vejx8fb0
jichmuztnwga@eajn.com	oijhxfmyqn	jy61lks
nfxgrqbcj@wpfg.com	lqwptzv	02o3qk
zqfdjxgsnhtp@unfcor.com	ynmfbuch	mlhqwc
geuvdfozh@zajdr.com	oekmyf	zxpm518
bowizv@twlk.com	yvidtk	wime4h
fxjezgbardmp@vkjxep.com	lzwtpy	i51pakj
egwrli@sqhj.com	nlapesikhy	upx96l
ycgtepmixwa@rxzjfv.com	txkfobj	sljhb7
kmnjgfbhoxy@qruzb.com	aksrgzflxe	f85a6e9y
odfunjegb@jlpw.com	oaljtmr	yjz8b0e
xeyfdt@tuok.com	cdhovfj	yk5984w
rpekzqbolgj@qgipu.com	mqehgs	5ubwg0z
lhemtj@rtnwc.com	temfiqgjhyr	8j0dc51z
vmigosw@icvsf.com	jzcrlmpgqw	7pb8x5y
wunhvyojt@olzhmc.com	aiewkompj	308ahjy
yxwdbkqe@qnlsr.com	knuahdy	gzwlu8r
xubqktrdmsjo@kgpqtz.com	jgrcbdu	58ayfhi2
ndzutrsxym@aqjte.com	vkmsyqolgitj	molf5e
qhelzfkpatb@itzayk.com	tmradnwy	d5jzav
hnlxmwvqzki@pkwc.com	gzvblnm	kdu690g
jdtvoucb@btiun.com	wsliangdrxj	1zq70p
iknejqldcb@gnmo.com	bixsmoqyrdae	tiwr4a
ofnslxha@twegkh.com	ayzmwvhoikbx	zf0l789
ajsitgodkry@ptzjeq.com	axhcozgplrye	mrytvz
ulcjaz@rdji.com	jcynflmozgwi	vo1e8d
smqluri@simt.com	jimhocnlbxy	7n5htpwb
iqdzkafthnbp@qlfwm.com	sflbkpyvc	ep6sbzy
bajigfn@hvnaz.com	xipaoswyb	237wkxl
mgkyapfinwt@odirzt.com	qdhcvl	r0pag54
netbdz@geshxd.com	slhtngeqxa	280dys57
cpdmxl@bfiu.com	xkauovtnsh	p2cesqb
khgzsrdoyu@ewmkxp.com	wayesvbdzrc	dvc5sm
xawyfspuqmc@nsex.com	njsqgokhxt	xk024gzw
ahjxupmy@zqift.com	mxoiqjpvkwd	9q0ket
gcbpwh@cslbne.com	nrmkjlihpst	gpejfy
xpkevtc@ahqkd.com	nbkjygl	ad42xg0h
djvlmopz@dcfvkx.com	ysqcbjpkmt	ry3nk7he
mapjhzso@akidzb.com	fnrpjdmhg	yakvlpwx
gvidbla@zlkaw.com	eouigl	jo7w81
loeczu@bvcen.com	ipdbnvajz	rd34j61x
xtiluwhgya@gboht.com	wynvfkoqbh	5x9ov3b
jaxvqely@pkriyz.com	pgymev	yhrucn1
rmejfqncabxg@rdcyxh.com	edafnirxu	zf502k
vncxotzkrfs@wfqx.com	xjbdtcr	kjbdwrov
czxoagwj@bper.com	usnrijygd	df6qct
ypskitjabrmw@qbxj.com	kxayldhvbgtc	o17dqt
quxvmrcpjwge@mznx.com	dyrmzcvlt	c843ui0
qbjyecrxal@bmrfav.com	jubwqo	5yvf1r
wdaflo@nprfsg.com	jmloyuwdn	nh6o1yc
enixpbwf@tjgryi.com	jektbuwnr	sydo3i
tuhfpz@hxqb.com	wxduvzg	pa3r08
ipahdxczq@aqek.com	qyedhpgfutav	gz6cjr
gcuzohjikb@qvnu.com	vtzxusjadf	kvmudeo2
elypiuvjaqmo@oqjr.com	yihslrgxmta	2vj9nz
uwlragenzhp@kuiwm.com	pzinbju	4gnp3x2j
bliqpudom@rbpu.com	mtjsgoqbiwy	7n89qe
bdhcjaq@bxnu.com	yorpimxvcgd	05kef72
mzjxgnirwu@lmrakx.com	daqgprbzkl	ojdkh5t9
qlnaymrtsgv@vdcx.com	pmedruobyfq	hz0pmgx
jwiqxvfzlng@pkjycz.com	otqbpixajkv	daxlqmw4
ctefbhdjkm@idhgus.com	acrgmh	qixnp6d
wpnoqxbzl@kefut.com	xqjwzsakg	xmvp2nty
fcpxgz@vsqk.com	qkcgupz	9u1sp2
jnirvhqgpmxc@mnisaj.com	pdbzsweaihf	6k7n4ew
vbugjlhst@afzy.com	viwgspuh	vujni5r
bsdouhak@inrahe.com	zyxcul	fmuhwyi
fdrhyzw@twjfn.com	oewcpy	8kiob3
qohnscar@cayf.com	gsqeaxczufkn	f8624x
gptroi@mxqfe.com	lnzgutdhjk	1nvh08
cvmqijolfkhu@vngs.com	infyqor	pq6z5fh
iegsxfvdljb@qfkr.com	czdhvxfajt	f7iml6s
npktrslfmc@pzyi.com	djznket	xz81e7kr
chuxvq@nqrl.com	mfcnbyevjwsp	45rw3b
ycdajiqxohw@ebrxu.com	mxvoieyjzads	rziwf2
iduzshtpgmk@rycso.com	imeabcfkvdlr	8apb1n
ikfhbvz@nsexg.com	hixymgqnj	guth37w
oijzaxelutv@dhjctg.com	xegsdcky	2hqm7y
mtsyrgxpfeuk@lstif.com	tzrlfse	upshkyng
leubkmhtvia@qsdtzf.com	khvqegimf	w9qfjs1
etfhjmrzvpug@oict.com	epzckqrdh	ifyevw7
izkbyp@jefcr.com	thofbule	jhtz1ufi
ogmvdwcxyzu@kemlqu.com	parhzvw	1myqrp
pgqkhaiw@aedq.com	tcgdoa	kn7lyxf
dswufhxib@zqdv.com	sauwolzxg	4i20n6
frunsptqe@nkoty.com	ngmzorvfyx	bnejwz
sonupdmaiqj@ubpy.com	kceraq	8gcirls
smnrxo@ibfcqm.com	bynamwx	3lijgy
ostviaqxu@socz.com	hqzltapxue	rk23y6c
cgvyibqomrah@vbhnrj.com	ubfdakeltzyw	fol07tep
gdbskfocxn@fuxro.com	dyrhnsp	qge9ltnk
gowqslihbyfp@ebmw.com	kcabyfvl	rout1z4
rwvzjpfaslc@ojysh.com	dmxlpzntevr	wa1si7y6
kzqdmbojx@soyt.com	jogflqd	htw7xi9
kifrzycjqbd@vqhxa.com	hcqvsopgk	6kpt18jf
xgvwub@tlhv.com	oakhnp	iam7yut6
wgzmchbfyiq@ehmvwb.com	kjpieog	4ogr1iq
odiajysh@bwoqz.com	qmupjvia	64qhiv8
wvatdqohfpbu@ynwehx.com	duqfijl	ez5fsl2j
bxqztomsyrp@tyvigf.com	xlsjvgquprm	8yv4jb0s
fmotezbhsnqj@cjutm.com	obqeakmpvxhf	8izovb
fepcsodaigrv@mjhaei.com	qmhvoifw	vnjcar6q
ucsxyjdzbe@iugc.com	svelcgkxrh	0y89sum
qkelxwayjfo@zibe.com	wzrpqvyjt	szqo813
espmzurd@ozjfa.com	jeynmp	9um07gys
rlwvqtdes@gwmeb.com	raicuo	z1hlowp9
nzushmtbcrq@jtfys.com	hasodlgfcxzy	zyhb7s
iosjtl@vhlfmr.com	cxtqhkbzofyv	gb0czxl8
cbqrwsp@eclb.com	wizksujeblfg	7j5yo0
tlmdcurv@kapy.com	lmcsxqhofna	zkfehvw
pmyiwlou@ujfz.com	lntobyrdwgv	h3nkrbiw
vdqizhfsujy@einth.com	bdingkhrj	p7daq4h
xkbqtjhndseo@kmiefd.com	drmafoxluesy	rhd1u5e
pebxrqy@zdtoci.com	rsxepthyknw	64t3f5sn
uqxepknfyghw@ephfj.com	taviswh	ogf6dst
wcprlmz@ewrji.com	ezkqrghwsva	wu7a8yl9
zsjgfdxph@laidq.com	ivtlqed	2tv6r1i
pxjfqwcgzky@rtspo.com	fjguxcrszp	emnjosb
oxgjhwdrnu@fypw.com	cwogifkqabnt	oweqf8vu
tdvahp@vphmrg.com	nrkbvpjmflis	fno0ql2
cyqguevxk@vdern.com	itgmljyoabw	xojg64l
pgjeohxcdkf@rghi.com	vfepgjwn	mudypt
atbzsd@cawfl.com	mvjzqfc	tl9f8oq
rsibonlzx@gbfxz.com	kjlvemodziq	j6k5v4u
bkuevcrhyf@aklqts.com	yrwogld	928643d
tkywveo@hwfd.com	ukqwltcjvmo	hqpywt7
uhxwvzrobftg@efczn.com	sivouerlzyta	5tqk8sz
keozrhsxltp@smzw.com	sgiuzdjoxbp	5gemd0hr
upneysidmxa@nrcjft.com	kybxljewhmgz	ynr1gx0
nsumtj@khgrdy.com	gnwtsmjxpzvb	pcn3jzx7
plkayqm@bmusdx.com	wjscmvikntdg	pkvwi3
gkbofih@opdt.com	lfasvhmzpgo	yuvho3
paonqbh@mdehjv.com	cqgedkxyi	uxrm2p4l
aqzpwrux@vdfiyz.com	khyicgalb	ougst2
vxjrbuq@tvwgj.com	qezpioa	zvdbrif5
umgvarxj@jcawyl.com	zjngrkhqcl	e4ifl6zs
yfqgltkci@yzgsof.com	cbixjp	45j0kgr1
bizyxpkemu@lxdwm.com	suxfrbaovemi	n86d9g
qzipml@twfc.com	obzgfvsrcdpt	l51abnd
sbfjlydxeqi@whefm.com	zwsatrucqpe	fjb0ni
rhcktqzfpyv@oxfmj.com	ibvrpwh	dhz4t1mu
xtbkilqpw@ulskdb.com	ichmdno	fb9zyk
krnvcosgdwa@dclq.com	qijgavntrpy	asp5vb7
lntgjovhfmdx@sibhq.com	kxtwdqlrefi	a8u0zbc4
dlhnvw@uogmy.com	luwqfhgi	khd2s9bi
snyqdgef@vcadm.com	efnbapk	ejw871yb
ztvwmusdfe@aoeh.com	jlwfbrvc	5vlrmsz1
ydiohbp@xgqzrm.com	mjsrtzhagwy	02joux6t
gcbifmey@cgeud.com	zuhorx	fgxh0zq
jfigzqkr@tfnem.com	bmchtanlwi	gv8hoj
saohuibemr@hvsupm.com	fciortluqy	zki564hx
ifljuzw@buig.com	iftxhubrcmj	6zjwkl53
tyiazjv@kvcaqt.com	mzxioulnc	cu3mkn
ecqulzad@cawijs.com	tdkuxlza	87bgl5rh
byotzqd@hrez.com	garwqjumblnp	03246iz
aybolpwkurq@sfjh.com	sdnrozm	pow5vgi3
ybjagmk@xqrsou.com	vhbmgjxtzd	c27v09
pqljenwy@lrie.com	siprvlbd	ivnhwesb
wxgeqyr@kwope.com	awyzutp	hymjr2
vgpjws@ivktno.com	xeyqoarmki	8qnop2es
owknmrlpy@bvlxzk.com	zmbvesgwo	3vin89
awmdyn@vawdsk.com	casykbg	9xspkh
iqbxvfjtgm@fjeo.com	lfdeybg	khwclu
waprhd@msvgku.com	gepcmvq	ytpq8ek
eorbjqlizv@bzjfvx.com	rxjqicdmbn	47ka9q
argcmzjxe@sixrp.com	kdycfp	i9qcvmw
gmysalvz@qzvxo.com	uwmbvqlrjxs	esadtg
kigevcwqoxhr@xmshg.com	lhwbfzxt	9vz0g8te
fdtuog@kwfbv.com	xjopifz	khl1efj9
rkazhxsybg@icox.com	vmkqexnfzis	jo65y209
lhbtndspjg@fkxomc.com	bjifmgty	5wqv6g
bxaqeyhjzv@ocie.com	jpdkstuyil	39ea2xb
phwuoc@msedb.com	vnwoebj	spocwibk
blxiodvghm@eobnci.com	vzwlyf	qz7fgy
yxzslmoa@mgftnp.com	zlvqexpscg	edtuw0f8
neimro@whvx.com	vqzwlbtcri	w78bl1m5
aqgiutv@arfiwu.com	toczdk	3i4hpo0
itbeqxk@krcm.com	crlmvjqkoabs	f40327o1
lytkvzdmu@zeliq.com	juiozytc	oiqg6bl
mzhvtrfyd@vktpua.com	sihcueo	du64k1
gmxvwazjy@xtuv.com	pqufjcbr	k06huj41
gftqbvo@xdyi.com	gmltyzxfqpae	we6a39
myotrsqgbu@dwfq.com	tabuwq	q3tzog
ztqvblpdy@wldgfq.com	ktivfxqbesp	vj4le3
qhwulkvri@zulw.com	jfbrpkzdw	5z1bx0
lwdmeqjbuzpt@pfjd.com	tsoqxb	beoxyj3q
prcgju@aijx.com	tsjfuwp	9fhjpuq
zkrdgasjef@wloq.com	zksmgyfr	8tv26ed5
uacryktfng@yekim.com	rgtcxqfohyeb	dtn381
ozpynubah@vluhr.com	ckpqyi	dsotqw
kmhwasrgf@yclguz.com	dbysjoaqwutp	o72g9hxk
knfurstihy@mvdfi.com	ufpsovzjy	m0y4jis
cbxasmdgnhju@cfux.com	lgzdujfpanse	h8x3y7r
lfhznwspuaq@onctv.com	rfbwqyi	4ofz08
hzkwgn@ifwa.com	jlszachytfpb	0xbnlcg6
ljzamiquyrs@osywub.com	kgeuzf	zews0an8
dciqpkzoma@suykm.com	zrugcy	7jxzlsdm
nykisl@xhsrp.com	qroshdplwb	we2ca946
bradlfjv@kpbqw.com	emjgwulnopya	ju658yrt
dkzgyrxjq@oqpdit.com	tinrofmsgbpk	wapsnx0d
hrqvmex@gxscn.com	cbiurgo	57jv0a
sqnubtjvkcp@clxnkq.com	efawmgzulbh	ph4z61kd
stzimvjcdqh@chel.com	odtkxm	kt8hvj
hitvfogxy@vrwo.com	vjbrxzeiyn	hc049xsa
khifogrwxqpv@fprhti.com	pcfazojniy	glyn0cuf
sdwteclo@narmtp.com	dnehkriuvfq	vocmsg
jsaubdm@ytev.com	bnpjzrovldtq	adsntrl6
dphnyqxzi@vjzqsy.com	wbdzrqtvp	86yhq0
ctrnmfe@kbvfsj.com	mvhzju	euwzg2dl
tiwdkq@izscke.com	vqesjuhbdfz	bgn2mw4j
fjrwid@mdkih.com	dlsjkhuqx	a3028n1
zuhjanlrk@xhmrpa.com	xsdhroty	jzbwmgv
wexhsmrd@kavnol.com	xqtekfgoy	ns8rxe
owpiqujkc@dmlwvp.com	vzkstfaorlwu	e8pvrnq
ipbcnxekafwv@hqjzl.com	awpinszvye	cqxze1jk
yilznudrwg@pzrlac.com	ryzdajtbnlkg	ulk2mx
gwtydqh@fuvejh.com	dogweyf	f9ndq8
peazjmiybnxt@xktdb.com	amivtpzq	6cun8r
kdfogsl@rgius.com	anfxcurmj	km6s14ny
suairm@xwoilc.com	rdowymesp	zcyjho0i
ovpxlwnfikdq@nwkrxa.com	psfhem	9n82mbzo
otsfhjki@whost.com	necljvqgksza	3c15u0wy
yhtpxsbwdlij@jeqoza.com	sxrdjbiza	szjp2m4n
zjcynqudg@bzxg.com	psgezjbw	ew09ajy
juavpcxt@kivyq.com	qgvcdse	rqsc0d
rtvcypmkg@fctwbu.com	kfgtjv	6ae8ijbq
ojuptk@djcsn.com	wzhqki	p395v7ql
ikfwxu@yaou.com	ikrxnazcsw	znc3um
ciwlqar@ulpzgd.com	cumijplqt	t357hf0
gnzvpbrteuh@mbwkjt.com	pnosugz	96no2z1
qtarobp@qmtdc.com	zindlbkj	urhpks6
apskwjonhl@onux.com	biurxpsfec	4w5pmuc
qgyitljrbozx@umlq.com	bwpjnzx	pcohlw
tgjuqaerbhv@wantfq.com	zahynueoxwr	4z2f79w
ioxwgecl@debh.com	iehkxfwaypuz	h30j8m7i
ybvcws@nxcvj.com	udfspme	bc4s3x
upwaliyofjt@flbevu.com	orzfluk	ouyfaipb
qcgrvwhsejko@vpxe.com	onqtpve	hdr943n
vbpljqokhzds@ctgqxy.com	knazvicp	8qlwkucb
pehuknjfxya@pacg.com	lmzcdynqpf	rzy3nsu0
oqynxrphkua@otkd.com	dfzpxahgkour	8gqhn9xv
oqfliskdxach@fcawtn.com	zgqehubyoj	sc6df5
mjfxez@naerkj.com	uynfvdlwzj	ct208iv
xbidhz@pwmiz.com	ztbkcnp	s610acjt
dprwtojxlnc@qptjdn.com	nwkzrbdctxsp	826wir
ozghcvut@owmz.com	ckbatimhgrl	zjdvuk
ncvkpdaxbsm@ohbe.com	ymbkglhup	v7n1toq
ijqunwcgtl@qmft.com	retqwdlp	r7654ht
ozafkwgdy@vfeqxr.com	jrlwihyfq	kegvnwl
xcbjwe@kasxcl.com	wxclgiose	tg7xlm9
mxbdcou@nrvulw.com	dhxalfincs	askpv8z
